                                                                                                    
                                                                                                    
                                                                                                    
                                                                                                    
                                                                                                    
                                                                                                    
                                                                                                    
                                                                              ░░░░░░░░░░▒▒▒▒▒▒▒▒▓▓▓▓
                                                                          ░█████████████████████▓▓▓▓
                                                              █████████████▓▓██▓▓▓▓▓▓▓▓▓▓▓▓▓▓▓▓▓▓▓▓▓
                                                    ▓██████████▓▓▓██▓█▓▓▓██▓▓██▓▓▓▓▓▓▓▓▓▓▓▓▓▓▓▓▓▓▓▓▓
                                                    ██▓███▓▓▓██▓▓▓████▓▓▓██▓▓██▓████████████████████
                                                    ██▓███▓▓▓██▓▓▓█████████▓▓██▓██▓▓▓▓▓▓▓▓▓▓▓▓▓▓▓▓▓▓
                                                    ██▓███▓▓▓██▓▓▓██▓██████▓▓██▓██▓▓▓▓▓▓▓▓▓▓▓▓▓▓▓▓▓▓
                                                     █████▓▓▓██▓▓▓█████████▓▓██▓████████████████████
                                                      ▒████████▓▓▓████▓▓▓██▓▓██▓▓▓▓▓▓▓▓▓▓▓▓▓▓▓▓▓▓▓▓▓
                                                             ▒█▓▓▓████▓▓▓██▓▓██▓▓▓▓▓▓▓▓▓▓▓▓▓▓▓▓▓▓▓▓▓
                                                             ▒█▓▓▓█████████▓▓██▓▓▓▓▓▓▓▓▓▓▓▓▓▓▓▓▓▓▓▓▓
                                                             ▒██▓▓██▓▓▓▓▓██▓▓██▓▓███████████████████
                                                              ░█████▓▓▓▓▓██▓▓██▓▓███████████████████
                                                                 ██████████▓▓██▓▓██▓▓▓▓▓▓▓▓▓▓▓▓▓▓▓▓▓
                                                                        ░██▓▓██▓▓███████████████████
                                                                        ░██▓▓██▓▓███████████████████
                                                                        ░██▓▓██▓▓▓▓▓▓▓▓▓▓▓▓▓▓▓▓▓▓▓▓▓
                                                                        ░██▓▓██▓▓▓▓▓▓▓▓▓▓▓▓▓▓▓▓▓▓▓▓▓
                                                                         ███▓██▓▓▓▓▓▓▓▓▓▓▓▓▓▓▓▓▓▓▓▓▓
                                                                           ████▓▓▓▓▓▓▓▓▓▓▓▓▓▓▓▓▓▓▓▓▓
                                                                              ██████████████████████
                                                                                                    
                                                                                                    
                                                                                                    
                                                                                                    
                                                                                                    
