                                                                                                    
                                                                                                    
                                                                                                    
                                                                                                    
                                                                                                    
                                                                                                    
                                                                                                    
                                                                                                    
                                                                                                    
                                                                             ░                      
                                                                          ▓███░                     
                                                                        ███▓▓█░            ░██░     
                                                                     ░████▓▓▓█░          ▓██▓█▒     
                                                                   ░██▓▓██▓▓▓█░        ▓███▓▓█▒     
                                                                ░█████▓▓██▓▓▓█░     ░███▓██▓▓█▒     
                                                              ░██▓▓███▓▓██▓▓██░   ▓███▓▓▓██▓▓█▒     
                                                              ▒█▓▓▓███▓▓▓███    ██████▓▓▓██▓▓█▓     
                                                           ░▓███▓▓▓███▓███    ░██▓▓███▓▓▓█████     ▓
                                                          ██████▓▓▓████▒     ░██▓▓▓███▓▓▓██       ██
                                                          ▒█▓▓██▓▓███     ░██▓██▓▓▓██████░       ███
                                                          ░███████▓       ▒█████▓▓▓███        ██▓▓██
                                                              ▒░          ░█▓▓██▓███▒         ██████
                                                  ▒█▒                       ▒████░            ██████
                                                █████                                           ░███
                                              ███▓▓██            ░███                               
                                           ▒████▓▓▓██          ▓██▓██               ░███▒           
                                        ▓███▓▓██▓▓▓██        ███▓▓▓██             ▒██▓▓█▒           
                                     ░█████▓▓▓██▓▓▓██     ▒█████▓▓▓██           ▓███▓▓▓█▒           
                                   ░██▓▓▓██▓▓▓██▓███▒  ▒███▓▓▓██▓▓▓██        ░███▓██▓▓▓█▒           
                                 ▓████▓▓▓██▓▓▓███▒   ███▓██▓▓▓██▓▓▓██     ░████▓▓▓██▓▓▓█▓           
                               ███▓███▓▓▓██▓▓██▓  ░███▓▓▓██▓▓▓█████▒    ███▓███▓▓▓██▓▓██▓           
                               ██▓▓███▓▓▓████░  ██████▓▓▓██▓▓▓██░     ████▓▓███▓▓▓█████             
                            ▓████▓▓███▓███░    ██▓▓▓██▓▓▓██████░   ▒██████▓▓███▓▓▓██                
