                                                                                                    
                                                                                                    
                                                                                                    
                                                                            ███████████████         
                                                                            █▓▓▓▓▓▓▓▓▓▓▓▓▓██        
                                                                            ███▓▓▓█▓▓▓▓▓▓▓██        
                                                                            █▓█▓▓▓█▓▓██▓▓▓█         
                                                                            ██▓█▓▓█▓▓▓█▓▓██         
                                                                            ██▓█▓▓█▓▓▓█▓▓██         
                                                                            ██▓█▓▓▓█▓▓█▓▓█          
                                                                            ██▓█▓▓▓█▓▓▓█▓█          
                                                                            ██▓█▓▓▓█▓▓▓█▓█          
                                                                            ██▓█▓▓▓█▓▓▓█▓█          
                                                                             █▓█▓▓▓█▓▓▓█▓█          
                                                                             █▓█▓▓██▓▓▓█▓█          
                                                                             █▓█▓▓█▓▓▓▓█▓█          
                                                                             ████▓█▓▓▓▓█▓█          
                                                                             ██▓█▓█▓▓▓▓█▓█          
                                                                             ██▓█▓█▓▓▓▓█▓█          
                                                                              █▓█▓█▓▓▓█▓▓█          
                                                                              ███▓█▓▓▓█▓▓█          
                                                                               ██▓▓█▓▓█▓▓█          
                                                                               ██▓▓█▓▓█▓▓█          
                                                                               ██▓▓▓▓▓█▓▓█          
                                                                                ███▓▓▓▓███          
                                                                                    █████           
                                                                                                    
                                                                                                    
                                                                                                    
                                                                                                    
                                                                                                    
                                                                                                    
                                                                                                    
