  ▒███░   ▓████     ▓      ▓█  ▓█ ▓█  █░░██             ▒▓    ░████    ░████ ▓  ▒█░ █▒    ▓▓       ▒
░██▒██ ██████  ███  ▓█      ███▒▒██▓  ▓██            ▓▒  ░███░ ████   ▓█▓▓█░ ███████▒    ▒██        
█▓▒▒███▓▒██  ██▒    █▒  ░█     ▒████████░             ██     ▓██████░░█▒▒▓█▒██▓███░▒█▓█▓▓██▓   ░█   
▒▒▒▒██▒▒██░░█▒     █▓ ░██        ▒█▒▒██░              ░██  ▒   ░▓██▓███▒▒███▒▓█░   ▒█▒▓████  ░██    
▒▒▒▒▒▒▓██▒▒▒      ░█ ██          ░█▒▒█                  ████▓     ██▒▒▒▒▒██▒▒█▓ ▓  ████▒██▓▒▒░      
▒▒▒▒▒▒█▓   █▓  ░█▒███            ░████▓                 ░█████  ▓█▒█▓▒▒▒▒▒▒▒██ ▒███▒▒▒██████        
▒▒▒▒▒██ ░██▒   █████                                       ██████▓ ██▒▒▒▒▒▒▒████▓▒▒███▒  ▓███       
▒▒▒▒▓███▓    ▓█▓▒██                                         ░██▓██░░█▓▒▒▒▒▒████████                 
▒▒▒▒█▓     ▓██▒▒██                                            ▒██▓███▓▒▒▒▒▒▓▓██                     
▒▒▒██   ░███▒▒▓██                                               █████▒▒▒▒▒▒██                       
▒▒▓█  ███▒▒▒▒██▒                                                 ░██▒▒▒▒▒▓█▓                        
▒▒▓███▓▒▒▒▒▒██                                                    ░█▓▒▒▒▒▓█                         
▒▒▒▒▒▒▒▒▒▒▓██                                                      ██▒▒▒▒▓█                         
▒▒▒▒▒▒▒▒▒▓█▒                                                       ██▒▒▒▒▓█                         
▒▒▒▒▒▒▒▒██░                                               ███████████▒▒▒▒▓█                         
▒▒▒▒▒▒▒██░                                               █▓▒▒▒▒▒▒▒▓█▓▒▒▒▒▓█                         
▒▒▒▒▒▒██░                                               ██▒▒▒▒▒▒▒▒██▒▒▒▒▒▒█                         
▒▒▒▒▒▓█░                                               ████████████▓▒▒▒▒▒▒██                        
▒▒▒▒▒█▓                                                █         ▓█▒▒▒▒▒▒▒██                        
▒▒▒▒██                                                           █▓▒▒▒▒▒▒▒▒█                        
▒▒▒▒█▒                                                          ██▒▒▒▒▒▒▒▒▒██                       
▒▒▒▓█                                                          ██▒▒▒▒▒▒▒▒▒▒▒██                      
▒▒▒██                                                         ██▒▒▒▒▒▒▒▒▒▒▒▒▒█▒                     
▒▒▒█▓                                                        ░███▓▒▒▒▒▒▒▒▒▒▒▒██           █         
▒▒▓█░                                                            ░▓██████████▒       ███████        
▒▒▓█                                                                                 █░░░██▓██      
▒▒▓█                                                                                 ██████▓▒██     
▒▒▒█▒                                                                                ██▒▒▒██▓▒██    
▒▒▒██                                                                                ███▒▒▒███▒▓██  
▒▒▒▒██                                                                                 ██▓▒▒▓██▒▒█  
▒▒▒▒▒█▓                                                                                  █▓▒▒▓██▓█  
▒▒▒▒▒▓█░                                                                                  █▓▒▒▓███  
▓▒▒▒▒▒▓█▒                                                                                 ███████   
