                                                                                 ▒██████████████████
                                                                               ░███        ▓█       
                                                                             ░██  █        ▓█       
                                                                           ░██    █        ▒█       
                                                                           ██    ░█        ▒█       
                                                                           ██    ░█        ▒█       
                                                                           ██    ░█        ▒█       
                                                                           ██    ░█        ▒█       
                                                                           ██    ░█        ▒█       
                                                                           ██    ░█        ░█       
                                                                           ██    ░█        ░█       
                                                                           ██    ░█        ░█       
                                                                           ██    ░█        ░█░      
                                                                           ██    ░█        ░█░      
                                                                           ██    ░█        ░█░      
 ▒████▓                                                                    █████████████████████████
 ██▓▓▓███▒                                                                 ██░░░░▒█░░░░░░░░▒█▒░░░░░░
 ░██▓▓▓▓▓██▓                                                               ██    ░█         █░      
  ▒██▓▓██████████▓▓▓                 ░▓▓ ░▓  ▓▓                            ██    ░██████████████████
  ▒█████▓▓▓██▒                     ▓█████████████                          ██    ░█         █░      
  █░  █▓  ▒█        ▒▓░ ▓▓  ░▓▒  ▓▓██          ▒█          ▒▓▒             ██    ░█         █▒      
 ██  ▒█   █▒        ▓█▒▓▓▓░ ███░▒▓▓▒ ░▓▓▒              ▒███▓▓████▓         ██    ░█         █▒      
░█   █▒  ▓█      █▓▒▒▒▒▒▒▒▒▒▒▒▒▒▒░░▒▒░░░▒▒██          ██▓▓▓▓▓▓▓▓▓██  ░     ██    ░█         █▒      
█▓  ▒█   █░      █░                       ██         ▓█▓▓▓▓▓▓▓▓▓█████████████    ░█         █▒      
█   █▓  ██       ▒                        ▓█         ██▓▓▓▓▓██████▓▓▓▓▓▓▓▓███    ░█         █▒      
▒▓██████████████████████████████████░                ▓█▓▓▓▓▓▓███▓▓▓▓▓▓▓▓▓▓▓▓██   ░█         █▒      
██▓▓▓▓▓▓▓▓▓▓▓▓▓▓▓▓▓▓▓▓██████████████░                 ██▓▓▓▓███▓▓▓▓▓▓▓▓▓▓▓▓▓██▓  ░█         █▒      
██▓▓▓▓▓▓▓▓▓▓▓▓▓▓▓▓▓▓▓▓▓▓▓▓▓▓▓▓▓▓███                    ███▓▓███▓▓▓▓▓████▓▓▓▓▓██  ░█         █▒      
█████████████████████████████████▒                        ▓████▓▓▓▓▓▓█████▓▓▓██  ░█         █▒      
                                                             ██▓▓▓▓▓▓▓▓▓██▓▓██▒  ░█         █▓      
                                                              ███▓▓▓▓▓▓▓▓▓▓██▓   ░█         █▓      
                                                               ▒███▓▓▓▓▓████     ▓█         █▓      
                                                                  ▒██████░       ░██████████████████
