                                                                                                    
                                                                                                    
                                                                                                    
                                                                                                    
                                   ░██████████████████████████░                                     
                               ▓████▓▓▓▓▓▓▓▓▓▓▓▓▓▓▓▓▓▓▓▓█████████                                   
                          ░█████▓▓▓▓▓████████████████████▓▓▓▓▓▓▓███░                                
                        ░█████████████████████████▓▓▓▓▓▓▓▓▓▓▓▓▓▓▓▓▓███                              
                       ░██▓▓▓▓▓▓▓▓▓▓▓▓▓▓▓▓▓▓▓███▓▓▓▓▓▓▓▓▓▓▓▓█████▓▓▓▓██                             
                       ██▓▓▓▓▓▓▓▓▓▓▓▓▓▓▓▓▓▓▓███▓▓▓▓▓▓▓▓████████▓██▓▓▓██                             
                      ▒██████████████████████▓▓▓▓████████████▓▓▓██▓▓▓▓██                            
                       ██▓▓▓█████████████████▓▓▓▓██▓▓▓▓▓██████▓▓▓██▓▓▓██                            
                       ██▓▓▓██▓▓▓▓▓▓▓▓▓▓▓▓▓██▓▓▓▓███▓▓▓▓▓█████▓▓▓██▓▓▓▓██                           
                   ███████▓▓██▓▓▓▓▓▓▓▓▓▓▓▓▓▓██▓▓▓▓██▓▓▓▓▓█████▓▓▓██▓▓▓▓██                           
                 ░██▓▓▓▓██▓▓███▓▓▓▓▓▓▓▓▓▓▓▓▓██▓▓▓▓███▓▓▓▓██████▓▓▓██▓▓▓▓█▓                          
                ░██▓▓▓▓▓██▓▓▓██▓▓▓▓▓▓▓▓▓▓▓▓▓▓██▓▓▓▓██▓▓▓▓▓█████▓▓▓██▓▓▓▓██                          
               ▓██▓▓▓▓▓▓▓██▓▓██▓▓▓▓▓▓▓▓▓▓▓▓▓▓██▓▓▓▓▓██▓▓▓▓██████▓▓▓██▓▓▓▓█▒                         
                ██▓▓▓▓▓▓▓██▓▓██▓▓▓▓▓▓▓▓▓▓▓▓▓▓██▓▓▓▓▓██▓▓▓▓▓█████▓▓▓██▓▓▓▓██                         
                ▓█▓▓▓▓▓▓▓███████▓▓▓▓▓▓▓▓▓▓▓▓▓▓██▓▓▓▓▓██▓▓▓▓▓█████▓▓██▓▓▓▓██                         
                 ██▓▓▓▓█████████▓▓▓▓▓▓▓█████▓▓██▓▓▓▓▓██▓▓▓▓▓████████▓▓▓▓▓▓██                        
                 ▓█▓▓▓██████████▓▓▓▓▓▓██▓▓▓██████▓▓▓▓▓████████▓████▓▓▓▓▓▓▓██                        
                 ░██▓▓███████████▓▓▓▓▓██▓▓▓▓▓████▓▓▓▓▓▓███▓▓▓▓▓▓▓▓▓▓▓▓▓▓▓▓▓██                       
                  ██▓▓███████████▓▓▓▓▓██████▓█████▓▓▓▓▓▓▓▓▓▓▓▓▓▓▓▓▓█████████                        
                  ░█████████████▓▓▓▓▓▓██░  ░▓██▓██▓▓▓▓▓▓▓▓▓████████████████▒                        
                    ▒▒▒██████▒▒█████████      █████████████▒        ▓█████                          
                                               ░░░▒▒                                                
                                     ░░                                                             
                               ░███████████░                                                        
                              ▓██████████████                                                       
                              ▓██████████████                                                       
                              ███████████████                                                       
                               ██████████████                                                       
                                   ░▓▓▓▓▒                                                           
