█████████████▒▒▒▒▒▒▒▒▒▒▒▒▒▒▒▒██████▓▓▒▒▒▒▒▒▒▒▒▒▒▒▒▒▒▒▒▒▒█▒        ██▒▒▒▒█████████▓▒▒▒▒▒▒▒▒▒▒▒▒▒▒▒▒▒▓
█████████████▒▒▒▒▒▒▒▒▒▒▒▒▒▒▒▒███████████▓▒▒▒▒▒▒▒▒▒▒▒▒▒▒▒█▒        ██▒▒▒▒█████████▓▒▒▒▒▒▒▒▒▒▒▒▒▒▒▒▒▒▒
█████████████▒▒▒▒▒▒▒▒▒▒▒▒▒▒▒▒███████████▓▒▒▒▒▒▒▒▒▒▒▒▒▒▒▒█▒        ██▒▒▒▒█████████▓▒▒▒▒▒▒▒▒▒▒▒▒▒▒▒▒▒▒
█████████████▒▒▒▒▒▒▒▒▒▒▒▒▒▒▒▒▓██████████▓▒▒▒▒▒▒▒▒▒▒▒▒▒▒▒█▒        ██▒▒▒▒▓▓███████▓▒▒▒▒▒▒▒▒▒▒▒▒▒▒▒▒▒▒
█████████████▒▒▒▒▒▒▒▒▒▒▒▒▒▒▒▒▓███████████▒▒▒▒▒▒▒▒▒▒▒▒▒▒▒█▒        ██▒▒▒▒▒▒▒▒▒▒▒▓▒▒▒▒▒▒▒▒▒▒▒▒▒▒▒▒▒▒▒▒
█████████████▒▒▒▒▒▒▒▒▒▒▒▒▒▒▒▒▓███████████▒▒▒▒▒▒▒▒▒▒▒▒▒▒▒█▒        ██▒▒▒▒▒▒▒▒▒▒▒▒▒▒▒▒▒▒▒▒▒▒▒▒▒▒▒▒▒▒▒▒
█████████████▒▒▒▒▒▒▒▒▒▒▒▒▒▒▒▒▒███████████▒▒▒▒▒▒▒▒▒▒▒▒▒▒▒█▒        ██▒▒▒▒▒▒▒▒▒▒▒▒▒▒▓█████▓▒▒▒▒▒▒▒▒▒▒▒
█████████████▒▒▒▒▒▒▒▒▒▒▒▒▒▒▒▒▒█████████▓▒▒▒▒▒▒▒▒▒▒▒▒▒▒▒██▒        ░▓████▓▒▒▒▒▒▒▒▒▒███████▓▒▒▒▒▒▒▒▒▒▒
█████████████▒▒▒▒▒▒▒▒▒▒▒▒▒▒▒▒▒██████▓▒▒▒▒▒▒▒▒▒▓███▓▒▒▓██               ░█████▒▒▒▒▒███████▓▒▒▒▒▒▒▒▒▒▒
█████████████▒▒▒▒▒▒▒▒▒▒▒▒▒▒▒▒▒▓██▓▒▒▒▒▒▒▒▒▒▒▒█████▓▒██▒                     ▒████▓███████▓▒▒▒▒▒▒▒▒▒▒
█████████████▒▒▒▒▒▒▒▒▒▒▒▒▒▒▒▒▒▒▒▒▒▒▒▒▒▒▒▒▒▒▒▒████████                           ░▓███████▓▒▒▒▒▒▒▒▒▒▒
████████▓▒▒▒▒▒▒▒▒▒▒▒▒▒▒▒▒▒▒▒▒▒▒▒▒▒▒▒▒▒▒▒▒▒▒▒▒██████░                                 ░▓████▓▒▒▒▒▒▒▒▒
███▓▒▒▒▒▒▒▒▒▒▒▒▒▒▒▒▒▒▒▒▒▒▒▒▒▒▒▒▒▒▒▒▒▒▒▒▒▒▒▒▒▒████▓                                        ░█████▒▒▒▒
▒▒▒▒▒▒▒▒▒▒▒▒▒▒▒▒▒▒▒▒▒▒▒▒▒▓██▓▒▒▒▒▒▒▒▒▒▒▒▒▒▒▒▒███                                               ▒████
▒▒▒▒▒▒▒▒▒▒▒▒▒▒▒▒▒▒▒▒▒▒▓██████▒▒▒▒▒▒▒▒▒▒▒▒▒▒▒██▒                                                     
▒▒▒▒▒▒▒▒▒▒▒▒▒▒▒▒▒▒▒██████████▒▒▒▒▒▒▒▒▒▒▒▒▒▓██                                                       
▒▒▒▒▒▒▒▒▒▒▒▒▒▒▒▒▓████████████▒▒▒▒▒▒▒▒▒▒▒▒██                                                         
▒▒▒▒▒▒▒▒▒▒▒▒▒▒▒▒▓████████████▒▒▒▒▒▒▒▒▒▒██▓                                                          
▒▒▒▒▒▒▒▒▒▒▒▒▒▒▒▒▓███████████▓▒▒▒▒▒▒▒▒▓██                                                            
▒▒▒▒▒▒▒▒▒▒▒▒▒▒▒▒▓███████████▓▒▒▒▒▒▒▒██▒                                                             
▒▒▒▒▒▒▒▒▒▒▒▒▒▒▒▒▓███████████▒▒▒▒▒▒▓██                                                               
▒▒▒▒▒▒▒▒▒▒▒▒▒▒▒▒▓███████████▒▒▒▒▒██░                                                                
▒▒▒▒▒▒▒▒▒▒▒▒▒▒▒▒▓███████████▒▒▒██▓                                                                  
▒▒▒▒▒▒▒▒▒▒▒▒▒▒▒▒▓███████████▒▓██                                                                    
▒▒▒▒▒▒▒▒▒▒▒▒▒▒▒▒▓█████████████▒                                                                     
▒▒▒▒▒▒▒▒▒▒▒▒▒▒▒▒▒████████████                                                                       
▒▒▒▒▒▒▒▒▒▒▒▒▒▒▒▒▒██████████▓                                                                        
▒▒▒▒▒▒▒▒▒▒▒▒▒▒▒▒▒█████████                                                                          
▒▒▒▒▒▒▒▒▒▒▒▒▒▒▒▒▒███████                                                                            
▒▒▒▒▒▒▒▒▒▒▒▒▒▒▒▒▒█████▓                                                                             
▒▒▒▒▒▒▒▒▒▒▒▒▒▒▒▒▒████                                                                               
▒▒▒▒▒▒▒▒▒▒▒▒▒▒▒▒▒██░                                                                                
▓▒▒▒▒▒▒▒▒▒▒▒▒▒▒▓██                                                                                  
