                                                                              ░▒▒███████████████████
                                                                ░░           ▒███████████████▓▓▓▓▓▓▓
                                                       ░█████████████████    ▒█▓▓▓▓▓▓██▓▓▓▓▓▓▓▓▓▓▓▓▓
                                                       ██▓▓▓▓▓▓▓██▓▓▓▓▓██    ▒█▓▓▓▓▓▓██▓▓▓▓▓▓▓▓▓▓▓▓▓
                                                       ███████▓▓██▓▓▓▓▓██    ▒█▓▓▓▓▓▓██▓▓▓▓▓▓▓▓▓▓███
                                                       ██▓▓▓▓█████▓▓▓▓▓██    ▒██████████████████████
                                                       ██▓▓▓▓▓▓▓██▓▓▓▓▓██    ▒█▓▓▓▓▓▓██▓▓▓▓▓▓▓▓▓▓▓▓▓
                                                       ██▓▓▓▓▓▓▓██▓▓▓▓▓██    ▒█▓▓▓▓▓▓██▓▓▓▓▓▓▓▓▓▓▓▓▓
                                                       ██▓█████▓██▓▓▓▓▓██    ▒█▓▓▓▓▓▓██▓▓▓▓▓▓▓▓▓▓▓▓▓
               ░                                       ██▓▓▓▓▓████▓▓▓▓▓██    ▒█████████▓▓▓▓▓▓▓▓▓▓▓▓▓
            ▒████████░                                  ███▓▓▓▓▓██▓▓▓▓▓██    ▒██████████████████████
          ▓██▓▓▓▓▓████                                    ██▓▓▓▓██▓▓▓▓▓██    ▒█▓▓██████████▓▓▓▓▓▓▓██
        ███▓▓▓▓▓▓██▒██                █████████████████████████████▓▓▓▓██    ▒█▓▓▓▓▓▓██▓▓▓████████▓▓
     ░███▓▓▓▓▓▓▓██░ █▓               ██▓▓▓▓▓▓▓▓▓▓▓▓▓▓▓▓▓▓▓▓▓▓▓▓▓▓▓████▓██    ▒█▓▓▓▓▓▓██▓▓▓▓▓▓▓▓▓▓███
    █████████████░                  ██▓▓▓▓▓▓▓▓▓▓▓▓▓▓▓▓▓▓▓▓▓▓▓▓▓▓▓▓▓▓▓████    ▒█▓▓▓▓▓▓██▓▓▓▓▓▓▓▓▓▓▓▓▓
    ▓█        ▒█░                 ░██▓▓▓▓▓▓▓▓▓▓▓▓▓▓▓▓▓▓▓▓▓▓▓▓▓▓▓▓▓▓▓▓▓▓██▓   ▒█▓▓▓▓▓▓██▓▓▓▓▓▓▓▓▓▓▓▓▓
    ▓█        ░█                 ░██▓▓▓▓▓▓▓▓▓▓▓▓▓▓▓▓▓▓▓▓▓▓▓▓▓▓▓▓▓▓▓▓▓▓▓▓▓███ ▒█████████▓▓▓▓▓▓▓▓▓▓▓▓▓
    ▓█        ░█                ░██▓▓▓▓▓▓▓▓▓▓▓▓▓▓▓▓▓▓▓▓▓▓▓▓▓▓▓▓▓▓▓▓▓▓▓▓▓▓▓▓███████▓▓▓▓▓█████▓▓▓▓▓▓▓▓
                                ███████████████████████████████████████████████▓▓████▓▓▓▓▓▓██████▓▓▓
                                ██▓▓▓▓▓▓▓▓▓▓▓▓▓▓▓▓▓▓▓▓▓▓▓▓▓▓▓▓▓▓▓▓▓▓▓▓▓▓▓▓▓▓▓██▓▓▓▓▓████▓▓▓▓▓▓▓▓████
                                ██▓▓▓▓▓▓▓▓▓▓▓▓▓▓▓▓▓▓▓▓▓▓▓▓▓▓▓▓▓▓▓▓▓▓▓▓▓▓▓▓▓▓▓██▓▓▓▓▓▓██████▓▓▓▓▓▓▓▓▓
                                ██▓▓▓▓▓▓▓▓▓▓▓▓▓▓▓▓▓▓▓▓▓▓▓▓▓▓▓▓▓▓▓▓▓▓▓▓▓▓▓▓▓▓▓██▓▓▓▓▓▓██▓▓▓█████▓▓▓▓▓
                                ████████████████████████████████████████████████████████▓▓▓▓▓█████▓▓
                                                                              ███▓▓▓▓▓▓███▓▓▓▓▓▓▓███
                                                                               ░██▓▓▓▓▓▓▓███▓▓▓▓▓▓▓▓
                                                                                 ▒██▓▓▓▓▓▓▓████▓▓▓▓▓
                                                                                   ███▓▓▓▓▓▓▓████▓▓▓
                                                                                     ██▓▓▓▓▓▓▓▓▓███▓
                                                                                      ▒██▓▓▓▓▓▓▓▓▓██
                                                                                        ▓██▓▓▓▓▓▓▓▓▓
                                                                                          ██▓▓▓▓▓▓▓▓
                                                                                           ░██▓▓▓▓▓▓
                                                                                             ▓██▓▓▓▓
