                            ▒█▓▒▒▒▒██                                       ▓█      ░███▓████▒▒███▓▓
                            ██▒▒▒▒▒██                                        ░██▓█░    ▒█▓▓█▒▒▓██▒▒█
                            ██▒▒▒▒▒██                                         ████▓     ██▒▒▒▒▒▒▒▒██
                           ██▒▒▒▒▒▒▓█                                           █████▓█░ █▓▒▒▒▒▒▒▓█▒
                          ░█▓▒▒▒▒▒▒▒█▒                                            ██▓██▒ ▓█▒▒▒▒▒▒███
                          ██▒▒▒▒▒▒▒▒██                                              ██▒██▒█▒▒▒▒▒▒███
                         ▒█▒▒▒▒▒▒▒▒▒▒█░                                              ▒█▓███▒▒▒▒▒▒██▒
                        ░█▓▒▒▒▒▒▒▒▒▒▒██                                                ███▓▒▒▒▒▒██  
                       ░█▓▒▒▒▒▒▒▒▒▒▒▒▒██                                                ▓█▒▒▒▒▒██   
                       ███▒▒▒▒▒▒▒▒▒▒▒▒▓█                                                 ██▒▒▒▒██   
                         ░▓████████████▒                                                 ██▒▒▒▒▓█   
                                                                                         ██▒▒▒▒▓█   
▓▓█     ░███         ░     ░                                                             █▓▒▒▒▒▓█   
███    ██▒██ ████████     ██                                                            ▓█▒▒▒▒▒▒█░  
████  ██▒▓█░▓██████▒▒ ▒▒ ███    ░                                                       ██▒▒▒▒▒▒█▒  
███▓███▒▒▓███▒██    ██▒████▒  ░█▓                                                      ██▒▒▒▒▒▒▒██  
  ██▒█▒▒▒██▒▒██    ░███▓▒██████                                                       ▒█▓▒▒▒▒▒▒▒▒█  
 ░▒█▓▒▒▒▒▒▒▒▒█▒ █████▒▒█████                                                          ██▒▒▒▒▒▒▒▒▒█▓ 
██ ██▒▒▒▒▒▒▒██▒██▓▒▒▓██▒░██▓▒░                                                       ▓█▒▒▒▒▒▒▒▒▒▒▓█░
██  █▓▒▒▒▒▒▓███▒▓███▒                                                               █████▒▒▒▒▒▒▒▒▒██
▓██ █▓▒▒▒▒▒█████▓                                                                  ▓███▒████▒▒▒▒▒▒▒█
█████▓▒▒▒▒▒▓█▓                                                                      ░██▒▒▒▒█████████
 ▒██▓▒▒▒▒▒██                                                                        ░██▒▒▒▒▒▒▒▓██▓  
  ░█▓▒▒▒▒▓█                                                                    ▒█████▓███▓▒▒▒▒▒▒▒█▓ 
   ██▒▒▒▒▓█                                                                   ▒████▓▒▒▒▒▓███▒▒▒▒▒█▒ 
   ▒█▒▒▒▒▒█░                                                                  ▓█  ░███▓▒▒▒▒████▓▒█░ 
   ██▒▒▒▒▒█░                                                                  ██      ▓██▓▒▒▒▒████░ 
   ██▒▒▒▒▒█▒                                                                             █████████  
  ░█▓▒▒▒▒▒█▓                                                                               ██   ░█  
  ██▒▒▒▒▒▒██                                                                               █▒   ░█  
 ░█▓▒▒▒▒▒▒▓█                                                                              ░█░   ░█  
 ██▒▒▒▒▒▒▒▒█▓                                                                             ░█        
▓█▓▒▒▒▒▒▒▒▒▓█                                                                                       
