                                                                                                    
                                                                                                    
                                                                                                    
                                                                                                    
                                                                                                    
                                                                                                    
                                                                                                    
                                                                                                    
                                                                                                    
                                                                                                    
                                                              ░████                                 
                                                             ░██▓▓██                                
                                                             ██▓▓▓▓█▒                               
                                                            ▓█▓▓▓▓▓█▒                               
                                                           ██▓▓▓▓▓██░                               
                                                         ▒██▓▓▓▓▓▓▓██░                              
                                                       ░██▓▓▓▓▓▓▓▓▓▓██                              
                                                     ░██▓▓▓▓▓▓▓▓▓▓▓▓▓█                              
                                                   ░██▓▓▓▓▓▓▓▓▓▓▓▓▓▓▓█                              
                                                 ░██▓▓▓▓▓▓▓▓▓▓▓▓▓▓▓▓██                              
                                                ▓██▓▓▓▓▓▓▓▓▓▓▓▓▓▓▓▓██░                              
                                               ██▓▓▓▓▓▓▓▓▓▓▓▓▓▓▓▓▓▓██                               
                                              ▒██▓▓▓▓▓▓▓▓▓▓▓▓▓▓▓▓▓▓██                               
                                              ██▓▓▓▓▓▓▓▓▓▓▓▓▓▓▓▓▓▓▓██                               
                                             ▒█▓▓▓▓▓▓▓▓▓▓▓▓▓▓▓▓▓▓▓██▒                               
                                            ░██▓▓▓▓▓▓▓▓▓▓▓▓▓▓▓▓▓▓██░                                
                                           ▓██▓▓▓▓▓▓▓▓▓▓▓▓▓▓▓▓▓██▓                                  
                                         ▒██▓▓▓▓▓▓▓▓▓▓▓▓▓▓▓▓▓▓▓█▓                                   
                                       ███▓▓▓▓▓▓▓▓▓▓▓▓▓▓▓▓▓▓▓▓▓██                                   
                                     ▓██▓▓▓▓▓▓▓▓▓▓▓▓▓▓▓▓▓▓▓▓▓▓▓▓██▒                                 
                                    ██▓▓▓▓▓▓▓▓▓▓▓▓▓▓▓▓▓▓▓▓▓▓▓▓▓▓▓███░                               
                                   ▒█▓▓▓▓▓▓▓▓▓▓▓▓▓▓▓▓▓▓▓▓▓▓▓▓▓▓▓▓▓▓▓███                             
                                    ██▓▓▓▓▓▓▓▓▓▓▓▓▓▓▓▓▓▓▓▓▓▓▓▓▓▓▓▓▓▓▓▓▓███▒                         
