▓▓▓▓▓███████▓▒                                                                                      
▓▓▓▓▓▓▓▓▓▓▓▓████████░                                                                               
███████▓▓▓▓▓▓▓▓▓▓▓▓███████▒                                                                         
▓▓▓▓█████████████▓▓▓▓▓▓▓▓▓███████▓░                                                                 
▓▓▓▓▓▓▓▓▓▓▓▓█████████████▓▓▓▓▓▓▓████████▓░                                                          
▓▓▓▓▓▓▓▓▓▓▓▓▓▓▓▓▓▓▓▓▓▓▓██████████▓▓████████                                                         
▓▓▓▓▓▓▓▓▓▓▓▓▓▓▓▓▓▓▓▓▓▓▓▓▓▓▓▓▓▓▓██████▓▓▓▓██                                                         
▓▓▓▓▓▓▓▓▓▓▓▓▓▓▓▓▓▓▓▓▓▓▓▓▓▓▓▓▓▓▓▓▓██▓▓▓▓▓▓██                                                         
▓▓▓▓▓▓▓▓▓▓▓▓▓▓▓▓▓▓▓▓▓▓▓▓▓▓▓▓▓▓▓▓▓██▓▓▓▓▓▓██                                                         
▓▓▓▓▓▓▓▓▓▓▓▓▓▓▓▓▓▓▓▓▓▓▓▓▓▓▓▓▓▓▓▓▓███▓▓▓▓▓██                                                         
▓▓▓▓▓▓▓▓▓▓▓▓▓▓▓▓▓▓▓▓▓▓▓▓▓▓▓▓▓▓▓▓███████████                                                         
▓▓▓▓▓▓▓▓▓▓▓▓▓▓▓▓▓▓▓▓▓▓▓▓▓▓▓▓▓████▒▒▒▒▒▓████                                                         
▓▓▓▓▓▓▓▓▓▓▓▓▓▓▓▓▓▓▓▓▓▓▓▓▓▓▓███▓▒▒▒▒▒▒███▓██                                                         
▓▓▓▓▓▓▓▓▓▓▓▓▓▓▓▓▓▓▓▓▓▓▓▓▓███▒▒▒▒▒▒▓███▓▓▓██                                                         
▓▓▓▓▓▓▓▓▓▓▓▓▓▓▓▓▓▓▓▓▓▓████▒▒▒▒▒▒▓███▓▓▓▓▓██                                                         
▓▓▓▓▓▓▓▓▓▓▓▓▓▓▓▓▓▓▓▓███▓▒▒▒▒▒▒██████▓▓▓▓▓██                                                         
▓▓▓▓▓▓▓▓▓▓▓▓▓▓▓▓▓▓███▒▒▒▒▒▒▒███▓▓██████████                                                         
▓▓▓▓▓▓▓▓▓▓▓▓▓▓▓▓███▒▒▒▒▒▒▒███▓▓███▒▒▒▒█████                                                         
▓▓▓▓▓▓▓▓▓▓▓▓▓████▒▒▒▒▒▒▓███▓▓███▒▒▒▒▓██▓▓██                                                         
▓▓▓▓▓▓▓▓▓▓▓███▓▒▒▒▒▒▒▓███▓▓███▒▒▒▒▒████████                                                         
▓▓▓▓▓▓▓▓▓███▒▒▒▒▒▒▒▓███▓▓███▒▒▒▒▒██▓▒▒▒▒██                                                          
▓▓▓▓▓▓████▒▒▒▒▒▒▒███▓▓▓███▓▒▒▒▒▓██▒▒▒▒██▒                                                           
▓▓▓▓███▓▒▒▒▒▒▒▒███▓▓▓███▒▒▒▒▒▓██▒▒▒▒▒██                                                             
▓▓███▒▒▒▒▒▒▒▒███▓▓▓███▒▒▒▒▒▒██▓▒▒▒▒██░                                                              
███▒▒▒▒▒▒▒▒███▓▓▓███▓▒▒▒▒▒▓█▓▒▒▒▒▓██                                                                
▓▒▒▒▒▒▒▒▓███▓▓▓███▓▒▒▒▒▒▓██▒▒▒▒▒██░                                                                 
▒▒▒▒▒▒▓███▓▓▓███▓▒▒▒▒▒▒██▒▒▒▒▒▓██                                                                   
▒▒▒▒███▓▓▓▓▓██▓▒▒▒▒▒▒██▓▒▒▒▒▒██                                                                     
▒▒███▓▓▓▓███▓▒▒▒▒▒▒▓██▒▒▒▒▒▓█▓                                                                      
███▓▓▓▓███▓▒▒▒▒▒▒▓██▒▒▒▒▒▒██                                                                        
█▓▓▓▓███▓▒▒▒▒▒▒▒██▓▒▒▒▒▒▓█▒                                                                         
▓▓▓▓██▓▒▒▒▒▒▒▒██▓▒▒▒▒▒▒██                                                                           
█████▒▒▒▒▒▒▒▓██▒▒▒▒▒▒▓█▒                                                                            
