▓▓▓▓▓▓▓▓▓▓▓▓▓▓▓▓▓▓▓▓▓▓▓▓▓▓▓▓▓▓▓▓▓▓▓▓▓▓▓██                                                           
██████████████▓▓▓▓▓▓▓▓▓▓▓▓▓▓▓▓▓▓▓▓▓▓▓▓▓██                                                           
            ▒▒▓████████████████▓▓▓▓▓▓▓▓██                                           █████████████▒  
                             ░░▒▒▓▒▒▒▒▒▒                                            ██▓▓▓██▓▓▓▓▓█▒  
                                                                                    ██▓▓▓██▓▓▓▓▓█▒  
                                                                                    ██▓▓▓██▓▓▓▓▓█▒  
                                                                                    ██▓▓▓██▓▓▓▓▓█▒  
                                                                                    ██▓▓▓██▓▓▓▓▓█▒  
                                  ░█████▓░                                          ██▓▓▓██▓▓▓▓▓█▒  
                               ▓███▓▓▓▓███                                          ▒████████████░  
                           ▒████▓▓▓▓▓▓███▓              ░▒▓▒░░░▓█░                                  
                       ▒████▓▓▓▓▓▓▓▓▓██▓█▓               ░░   ▒▓▓▓                                  
                    ████▓▓▓▓▓▓▓▓▓▓▓▓██▓▓█▓               ▒▒   ▒▓▓▓     ░███████░                    
                ▒████▓▓▓▓▓▓▓▓▓▓▓▓▓███▓▓▓█▒               ███▓▒░▓█      ███▓▓▓▓▓███                  
            ░████▓▓▓▓▓▓▓▓▓▓▓▓▓▓▓▓███▓▓▓██                              █▓██▓▓▓▓▓▓███▒               
        ░████▓▓▓▓▓▓▓▓▓▓▓▓▓▓▓▓▓▓▓███▓▓▓██                               █▒ ▒██▓▓▓▓▓▓▓███             
     ▓███▓▓▓▓▓▓▓▓▓▓▓▓▓▓▓▓▓▓▓▓▓▓██▓▓▓▓██▒░                              █▒   ██▓▓▓▓▓▓▓▓▓██▓          
 ░████▓▓▓▓▓▓▓▓▓▓▓▓▓▓▓▓▓▓▓▓▓▓▓▓██▓▓███▓▓▓▓▓███                                ▒██████████████        
██▓▓▓▓▓▓▓▓▓▓▓▓▓▓▓▓▓▓▓▓▓▓▓▓▓▓███▓▓▓██▓▓▓▓▓▓▓██░                                ██░░░░░░░░░░▓█        
▓▓▓▓▓▓▓▓▓▓▓▓▓▓▓▓▓▓▓▓▓▓▓▓▓▓▓███▓▓▓▓▓██▒▓██▓░█▓                                 ▓█          ░█        
▓▓▓▓▓▓▓▓▓▓▓▓▓▓▓▓▓▓▓▓▓▓▓▓▓▓███▓▓▓▓▓███   █  ▒█                                 ▒█           █░       
▓▓▓▓▓▓▓▓▓▓▓▓▓▓▓▓▓▓▓▓▓▓▓▓▓███▓▓▓▓▓███▒   █  ░█                                 ░█           ▓░       
▓▓▓▓▓▓▓▓▓▓▓▓▓▓▓▓▓▓▓▓▓▓▓▓██▓▓▓▓▓▓▓█▓█    █   █                                                       
▓▓▓▓▓▓▓▓▓▓▓▓▓▓▓▓▓▓▓▓▓▓▓██▓▓▓▓▓▓▓██░██▒  █  ██▒                                                      
▓▓▓▓▓▓▓▓▓▓▓▓▓▓▓▓▓▓▓▓▓███▓▓▓█████████▓░▓███░ ▓▓                             █████████████████▓       
▓▓▓▓▓▓▓▓▓▓▓▓▓▓▓▓▓▓▓▓███▓▓███▓▓▓▓▓▓▓▓▓██▓█    ░                                           ██▓█████▒  
▓▓▓▓▓▓▓▓▓▓▓▓▓▓▓▓▓▓▓███▓▓▓███▓▓▓▓▓▓▓▓▓██░                                                 ██▓▓▓▓▓▓███
▓▓▓▓▓▓▓▓▓▓▓▓▓▓▓▓▓▓██▓▓▓▓▓▓▓███████████░                                                  ███████████
▓▓▓▓▓▓▓▓▓▓▓▓▓▓▓▓▓██▓▓▓▓▓▓▓▓███  ▓█   █▒              █████  ░▒▒▓█████████                ██▓▓▓▓▓▓▓▓▓
▓▓▓▓▓▓▓▓▓▓▓▓▓▓▓▓██▓▓▓▓▓▓▓▓███▒  ▓█   █▓             ▒█▓▓▓██▒░░░    ░█░                   ██▓▓▓▓▓▓▓▓▓
▓▓▓▓▓▓▓▓▓▓▓▓▓▓███▓▓▓▓▓▓▓▓▓██▓   ▓█   ▓█             ██▓▓▓██         ▒█             ▒▒▒▓▓███▓▓▓▓▓▓▓▓▓
▓▓▓▓▓▓▓▓▓▓▓▓▓███▓▓▓▓▓▓▓▓▓▓██    ▓█   ░█             ██▓▓▓██░░░░░░░░░░██░░░  ███▓▒▒▒░      ▒█████▓▓▓▓
▓▓▓▓▓▓▓▓▓▓▓▓███▓▓▓▓▓▓▓▓▓▓███    ▓█   ▒█             ██▓▓▓██▒░░░░░░░░▒██░░░                     ▒████
