                                                                                       ▒▒▒▒▒▒▒▒▒    
                                                                                       ▒▒▒▒▒▒▒▒▒    
                                                                                       ▒▒▒▒▒▒▒▒▒▒   
                                                                                       ▒▒▒▒▒▒▒▒▒▒▒  
                                                                                       ▒▒▒▒▒▒▒▒▒▒▒  
                                                                                       ▒▒▒▒▒▒▒▒▒▒▒  
                                                                                      ▒▒▒▒▒▒▒▒▒▒▒▒  
                                                                                       ▒▒▒▒▒▒▒▒▒▒▒  
                                                                                        ▒▒▒▒▒▒▒▒▒   
                                                                                          ▒▒▒▒▒▒▒   
                                                                                           ▒▒▒▒▒▒▒  
                                                                                            ▒▒▒▒    
                                                                                                    
                                                                                                    
                                                                                                    
                                                                                                    
                                      ▒▒▒▒▒▒▒▒▒▒▒▒▒▒▒                                               
                                    ▒▒▒▒▒▒▒▒▒▒▒▒▒▒▒▒▒▒▒                                             
                                      ▒▒▒▒▒▒▒▒▒▒▒▒▒▒▒                                               
                                      ▒▒▒▒▒▒▒▒▒▒▒                                                   
                           ▒▒▒▒▒▒     ▒▒▒▒▒▒▒▒▒▒                                                    
                          ▒▒▒▒▒▒▒▒▒▒   ▒▒▒▒▒▒▒▒▒                                                    
                          ▒▒▒▒▒▒▒▒▒▒▒▒                                                              
                           ▒▒▒▒▒▒▒▒▒▒▒                                                              
                           ▒▒▒▒▒▒▒▒▒▒▒                      ▒▒                                      
                            ▒▒▒▒▒▒▒▒▒▒▒                  ▒▒▒▒▒▒▒                                    
                            ▒▒▒▒▒▒▒▒▒▒▒▒                 ▒▒▒▒▒▒▒                                    
                             ▒▒▒▒▒▒▒▒▒▒▒                ▒▒▒▒▒▒▒▒                                    
                              ▒▒▒▒▒▒▒▒▒                 ▒▒▒▒▒▒▒▒▒                                   
                               ▒▒▒▒▒▒▒▒                   ▒▒▒▒▒▒                                    
                               ▒▒▒▒▒▒▒                     ▒▒                                       
                               ▒▒▒▒▒                                    ▒▒▒▒▒▒▒                     
                                                                     ▒▒▒▒▒▒▒▒▒▒▒                    
