▒▒▒▒▒▒▒▒▒▒▒██▒▒▒▒▒▒▒▒▒▒▒▒▒▒▒▒▒▒▒▒██                              ██▒▒▒▒▒▒▒▒▒▒▒▒▒██▒▒▒▒▒▒▒▒▒▒▒▒▒▒▒▒▒▓
▒▒▒▒▒▒▒▒▒▒▒██▒▒▒▒▒▒▒▒▒▒▒▒▒▒▒▒▒▒▒▒██                              ██▓▒▒▒▒▒▒▒▒▒▒▒▒██▒▒▒▒▒▒▒▒▒▒▒▒▒▒▒▒▒▒
▒▒▒▒▒▒▒▒▒▒▒██▒▒▒▒▒▒▒▒▒▒▒▒▒▒▒▒▒▒▒▒▓█░                              ██▒▒▒▒▒▒▒▒▒▒▒▒██▒▒▒▒▒▒▒▒▒▒▒▒▒▒▒▒▒▒
▒▒▒▒▒▒▒▒▒▒▒██▒▒▒▒▒▒▒▒▒▒▒▒▒▒▒▒▒▒▒▒██                              ██▓▒▒▒▒▒▒▒▒▒▒▒▒██▒▒▒▒▒▒▒▒▒▒▒▒▒▒▒▒▒▒
▒▒▒▒▒▒▒▒▒▒▒██▒▒▒▒▒▒▒▒▒▒▒▓█▓▒▒▒▒▒▓██                             ▓█▓▒▒▒▒▒▒▒▒▒▒▒▒▒██▒▒▒▒▒▒▒▒▒▒▒▒▒▒▒▒▒▒
▒▒▒▒▒▒▒▒▒▒▒██▒▒▒▒▒▒▒▒▒▓██▓▒▒▒▒▒▒▒███                             ██▒▒▒▒▒▒▒▒▒▒▒▒▒██▒▒▒▒▒▒▒▒▒▒▒▒▒▒▒▒▒▒
▒▒▒▒▒▒▒▒▒▒▒██▒▒▒▒▒▒▒▓███▒▒▒▒▒▒▒▒▒▒▓██                           ██▓▒▒▒▒▒▒▒▒▒▒▒▒▒██▒▒▒▒▒▒▒▒▒▒▒▒▒▒▒▒▒▒
▒▒▒▒▒▒▒▒▒▓███▒▒▒▒▒▒███▓▒▒▒▒▒▒▒▒▒▒▒▒██                          ██▓▒▓▓▒▒▒▒▒▒▒▒▒▒▒██▒▒▒▒▒▒▒▒▒▒▒▒▒▒▒▒▒▒
▒▒▒▒▒▒▒▓█████▒▒▒▒▓██▓▒▒▒▒▒▒▒▒▒▒▒▒▓██                           ▓█▓███▓▒▒▒▒▒▒▒▒▒▒██▒▒▒▒▒▒▒▒▒▒▒▒▒▒▒▒▒▒
▒▒▒▒▒▓███▒▒██▒▒▒███▒▒▒▒▒▓████▓▒▒▓█▓                             ▓█████▒▒▒▒▒▒▒▒▒▒██▒▒▒▒▒▒▒▒▒▒▒▒▒▒▒▒▒▒
▒▒▒▒███▓▒▒▒██▒███▓▒▒▒▒▓███▓░██▒██▒                               ▓████▒▒▒▒▒▒▒▒▒▒██▒▒▒▒▒▒▒▒▒▒▒▒▒▒▒▒▒▒
▒▒███▓▒▒▒▒▒████▓▒▒▒▒▒▓████▓░████                                  ████▒▒▒▒▒▒▒▒▒▒██▒▒▒▒▒▒▒▒▒▒▒▒▒▒▒▒▒▒
▓██▓▒▒▒▒▒▒▒███▓▒▒▒▒▒▒█████▓░██▓                                    ███▒▒▒▒▒▒▒▒▒▒██▒▒▒▒▒▒▒▒▒▒▒▒▒▒▒▒▒▒
██▒▒▒▒▒▒▒▒▒██▒▒▒▒▒▒▒▒█████▓░██                                      ██▓▒▒▒▒▒▒▒▒▒██▒▒▒▒▒▒▒▒▒▒▒▒▒▒▒▒▒▒
▒▒▒▒▒▒▒▒▒▒▒██▒▒▒▒▒▒▒▒█████▓░██                                       ██▓▒▒▒▒▒▒▒▒██▒▒▒▒▒▒▒▒▒▒▒▒▒▒▒▒▒▒
▒▒▒▒▒▒▒▒▒▒▒██▒▒▒▒▒▒▒▒████████▒                                        ██▒▒▒▒▒▒▒▒██▒▒▒▒▒▒▒▒▒▒▒▒▒▒▒▒▒▒
▒▒▒▒▒▒▒▒▒▒▒██▒▒▒▒▒▒▒▒█████                                             ██▒▒▒▓█▓▒██▒▒▒▒▒▒▒▒▒▒▒▒▒▒▒▒▒▒
▒▒▒▒▒▒▓██▓▒██▒▒▒▒▒▒▒▒███▓                                               ██▓▓██████▒▒▒▒▒▒▒▒▒▒▒▒▒▒▒▒▒▒
▒▒▒▒▒▓███▓▒██▒▒▒▒▒▒▒▒██░                                                 ████▓████▒▒▒▒▒▒▒▒▒▒▒▒▒▒▒▒▒▒
▒▒▒▒█████▓▒██▒▒▒▒▒▒▒██                                                   ░██▒▒████▒▒▒▒▒▒▒▒▒▒▒▒▒▒▒▒▒▒
▒▒███▓▒██▓▒██▒▒▒▒▒▓██                                                     ██░▒████▒▒▒▒▒▒▒▒▒▒▒▒▒▒▒▒▒▒
▒▓██▒▒▒██▓▒██▒▒▒▒▓██                                                      ██░▒████▒▒▒▒▒▒▒▒▒▒▒▒▒▒▒▒▒▒
▒▓██▒▒▒██▓▒██▒▒▒▓█▓                                                       ██▒▓█▓██▒▒▒▒▒▒▒▒▒▒▒▒▒▒▒▒▒▒
▒▓██▒▒▒██▓▒██▒▒██▒                                                        ░██▓████▒▒▒▒▒▒▒▒▒▒▒▒▒▒▒▒▒▒
▒▓██▒▒▒██▓▒██▓██                                                               ▒██▒▒▒▒▒▒▒▒▒▒▒▒▒▒▒▒▒▒
▒▓██▒▒▒██▓▒████                                                                  ██▓▒▒▒▒▒▒▒▒▒▒▒▒▒▒▒▒
▒▓██▒▒▒██▓▒███                                                                    ▓█▓▒▒▒▒▒▒▒▒▒▒▒▒▒▒▒
▒▓██▒▒▒██▓██▓                                                                      ░██▓▒▒▒▒▒▒▒▒▒▒▒▒▒
▒▓██▒▒▒████░                                                                         ██▓▒▒▒▒▒▒▒▒▒▒▒▒
▒▓██▒▒▒███░                                                                           ▓██▒▒▒▒▒▒▒▒▒▒▒
▒▓██▒▒▓██                                                                               ██▓▒▒▒▒▒▒▒▒▒
▒▓██▒▓██                                                                                 ██▓▒▒▒▒▒▒▒▒
▓▓██▓█▒                                                                                   ▒██▒▒▒▒▒▒▒
