▓▓▓▓▓▓▓▓▓▓▓▓▓▓▓▓▓▓▓██                           ██▓▓▓▓▓▓▓▓▓▓▓▓▓▓▓▓▓▓▓▓▓▓▓▓▓▓▓▓▓▓▓▓▓▓▓▓▓▓▓▓▓▓▓▓▓▓▓▓▓█
▓▓▓▓▓▓▓▓▓▓▓▓▓▓▓▓▓▓▓██                          ██▓▓▓▓▓▓▓▓▓▓▓▓▓▓▓▓▓▓▓▓▓▓▓▓▓▓▓▓▓▓▓▓▓▓▓▓▓▓▓▓▓▓▓▓▓▓▓▓▓▓▓
▓▓▓▓▓▓▓▓▓▓▓▓▓▓▓▓▓▓▓██                         ▒██▓▓▓▓▓▓▓▓▓▓▓▓▓▓▓▓▓▓▓▓▓▓▓▓▓▓▓▓▓▓▓▓▓▓▓▓▓▓▓▓▓▓▓▓▓▓█████
▓▓▓▓▓▓▓▓▓▓▓▓▓▓▓▓▓▓▓██                         ██▓▓▓▓▓▓▓▓▓▓▓▓▓▓▓▓▓▓▓▓▓▓▓▓▓▓▓▓▓▓▓▓▓▓▓▓▓▓▓▓▓▓██████▓░  
▓▓▓▓▓▓▓▓▓▓▓▓▓▓▓▓▓▓▓██                        ▓██▓▓▓▓▓▓▓▓▓▓▓▓▓▓▓▓▓▓▓▓▓▓▓▓▓▓▓▓▓▓▓▓▓▓▓▓▓██████▒        
█████████████████████                        ██▓▓▓▓▓▓▓▓▓▓▓▓▓▓▓▓▓▓▓▓▓▓▓▓▓▓▓▓▓▓▓▓▓██████              
▓▓▓▓██░                                      ▒▓▓▓▓▓▓▓▓▓▓▓█████████████▓▓▓▓▓▓▓▓▓▓█░                  
▓▓▓▓██░                                                  ░██▓▓▓▓▓▓▓██                               
▓▓▓▓██░                                                  ░██▓▓▓▓▓▓▓██                               
▓▓▓▓██░                                                  ░██▓▓▓▓▓▓▓██                               
▓▓▓▓██░                                                  ░██▓▓▓▓▓▓▓██                               
▓▓▓▓██░                                                  ░██▓▓▓▓▓▓▓██                               
▓▓▓▓██░                                                  ░██▓▓▓▓▓▓▓██                               
▓▓▓▓██░                                                  ░██▓▓▓▓▓▓▓██                               
▓▓▓▓██░                                                   ██▓▓▓▓▓▓▓██                               
▓▓▓▓██░                                                   ██▓▓▓▓▓▓▓██                               
▓▓▓▓██░                                                   ██▓▓▓▓▓▓▓██                               
▓▓▓▓██░                                                   ██▓▓▓▓▓▓▓██                               
▓▓▓▓██░                                                   ██▓▓▓▓▓▓▓██                               
▓▓▓▓██░                                                   ██▓▓▓▓▓▓▓██                               
▓▓▓▓██░                                                   ██▓▓▓▓▓▓▓██                               
▓▓▓▓██░                                                  ▒██▓▓▓▓▓▓▓██                               
▓▓▓▓██░                                                  ▒██▓▓▓▓▓▓▓██                               
▓▓▓▓██░                                                  ▒██▓▓▓▓▓▓▓██                               
██████░                                                  ▓██▓▓▓▓▓▓▓██                               
░░░░░▒                                                   ▓███████████                               
                                                          ▒▒▒▒▒▒▒▒▒▒▒                               
                                                                                                    
                                                                                                    
                                                                                                    
                                                                                                    
                                                                                                    
                                                                                                    
