                                                                                                    
                                                                                                    
                                                                                                    
                                                                                                    
                                                               ███████████████                      
                                                         ██████░░░░░░░░░░░░░░░█████                 
                                                     ████░░░░░░░░░░░░░░░░░░░░░░░░░████              
                                                ████████░░░░░░░░░░░░░░░░░░░░░██░░░░░░██             
                                           █████░░░░░░██░░░░░░░░░░░░░░░░░░░░░██░░░░░░██             
                                      █████░░░░░░░░░░░██░░░░░░░░░░░░░░░░░░░░░░█░░░░░░██             
                                  ████░░░░░░░░░░█░░░░░██░░░░░░░░░░░░░░░░░░░░░░░░░░░░░██             
                              ████░░░░░░░░██░░░███░░░░██░░░░░░░░░░░░░░░░░░░░░░░░░░░░░██             
                             ██░░██░░██░░░██░░░███░░░░██░░░░░░░░░░░░░░░░░░░░░░░░░░░░░██             
                             ██░░██░░██░░░██░░░███░░░░██░░░░░░░░░░░░░░░░░░░░░░░░░░░░░██             
                             ███░░░░░░░░░░██░░░███░░░░██░░░░░░░░░░░░░░░░░░░░░░░░░░░░░██             
                               ░██░░░░░░░░░░░░░░░░░░░░██░░░░░░░█░░░░░░░░░░░░░░░░░░░░░██             
                                  ███░░░░░░░░░░░░░░░░░██░░░░░░░██░░░░░░░░░░░░░░░░░░░░██             
                                    ░███░░░░░░░░░░░░░░██░░░░░░░░░█░░░░░░░░░░░░░░░█░░░██             
                                      ░███░░░░░░░░█░░░██░░░░░░░░░░░░░░░░░░░░░░░░░██░░██             
                                         ▒██░░░░░░█░░░██░░░░░░░░░░░░░░░░░░░░░░░░░██░░██             
                                            ███░░░██░░██░░█░░░░░░░░░░░░░░░░░░░░░░░██░██             
                                              ░███░░░░██░░█░░░░░░░░░░░░░░░░░░░░░░░░░░██             
                                                ░███░░██░░░█░░░░░░░░░░░░░░░░░░░░░░░░░██             
                                                   ▒████░░░░░░░░░░░░░░░░░░░░░░░░░░░░░██             
                                                      █████████████████████████████████             
                                                                                                    
                                                                                                    
                                                                                                    
                                                                                                    
                                                                                                    
                                                                                                    
                                                                                                    
                                                                                                    
