                                                                                                    
                                                                                                    
                                                                                                    
                                                                                                    
███░                                                                                                
▒▒▓███▒                                                                                             
▒▒▒▒▒▓███▓                                                                                          
▒▒▒▒▒▒▒▒▓████░                                                                                      
▒▒▒▒▒▒▒▒▒▒▒▓▓███▒                                                                                   
▓▒▒▒▒▒▒▒▒▒▒▒▒▒▒▒███▓                                                                                
███▓▒▒▒▒▒▒▒▒▒▒▒▒▒▒▓████░                                                                            
  ▒███▓▒▒▒▒▒▓▓▓▒▒▒▒▒▒▓▓███▒                                                                         
     ▒███▓██████▓▒▒▒▒▒▒▒▒▓███                                    ░███                               
      ▒████▓▓▓▓█████▓▒▒▒▒▒▒▒█▒                                 ░██▓▒▓██                             
  ▒█████▓▓▓▓▓▓▓▓▓▓█████▓▒▒▒▒█▒                                ███▓▒▒▒▒▓██░                          
████▓▓▓▓▓▓▓▓▓▓▓▓▓▓▓▓▓████▒▒▒█▒                                █████▓▓█████                          
▓▓▓▓▓▓▓▓▓▓▓▓▓▓▓▓▓████████▒▒▒█▒            ▓▓                  ██▒▒████▓▒██                          
▓▓▓▓▓▓▓▓▓▓▓▓▓█████▓ ▒████▒▒▒█▒           ▒████▓               ██▒▒▒██▒▒▒██                          
▓▓▓▓▓▓▓▓▓▓████▓░       ████▓█▒           ▒█▓▒▓███▓            ░███▓██▒▓██▒                          
▓▓▓▓▓▓▓████░  ░██████  █▒ ▒██▒           ▓█▓▒▒▒▒▓███▓            ▒█████░                            
▓▓▓█████      ▓█▓▓▓▓█▓ █▒                ██▓▒▒▒▒▒▒▒▒███▒                                            
█████          █ ░▓ ▒░                   ██▓▒▒▒▒▒▒▒▒▒▒▓███▒                                         
▓  ██          ▓  ▒ ██████████████▓▒     ██▒▒▒▒▒▒▒▒▒▒▒▒▒▒▓███▓                                      
   ██         ▒▒  ▒  █           ▒█████▓ ██▒▒▒▒▒▒▒▒▒▒▒▒▒▒▒▒▒▓███▒                                   
   ██         ▓ ░██▓ ▓           ▒█▓▓▓▓█████▓▓▓▒▒▒▒▒▒▒▒▒▒▒▒▒▒▒▒▒███░                                
   █▓             ░              ▒███████████████▒▒▒▒▒▒▒▒▒▒▒▒▒▒▒▒▒▓███▒                             
                                 ▒█████████▓▓▓███▓▒▒▒▒▒▒▒▒▒▒▒▒▒▒▒▒▒▒▒▓███▒                          
                                 ▒█▓▓▓▓▓▓▓▓▓▓▓▓█████▒▒▒▒▒▒▒▒▒▒▒▒▒▒▒▒▒▒▒▒▓███░                       
                                 ▒█▓▓▓▓▓▓▓▓▓▓▓▓█▒  ▓███▓▒▒▒▒▒▒▒▒▒▒▒▒▒▒▒▒▒▒▒▓███░                    
                     █████████████████▓▓▓▓▓▓▓▓▓█▒     ▒███▓▒▒▒▒▒▒▒▒▒▒▒▒▒▒▒▒▒▒▒▓███░                 
                                     ▒█████▓▓▓▓█▒        ░███▓▒▒▒▒▒▒▒▒▒▒▒▒▒▒▒▒▒▒▒▓███░              
                                          ▒█████▒            ███▓▒▒▒▒▒▒▒▒▒▒▒▒▒▒▒▒▒▒▒▓███            
                            ████████████████▓▓▓▓               ░███▓▓▒▒▒▒▒▒▒▒▒▒▒▒▒▒▒▒▒▒▓███░        
