█████████████████▓▓▓██▒                                                                             
▓▓▓▓▓▓▓▓▓▓▓▓██████████▒                                                                             
▓▓▓▓▓▓▓▓▓▓▓▓▓██▓▓▓▓▓▓█▒                                                                             
▓▓▓▓▓▓▓▓▓▓▓▓▓██▓▓▓▓▓▓█▒                                                                             
▓▓▓▓▓▓▓▓▓▓▓▓▓██▓▓▓▓▓▓█▒                                                                             
▓▓▓▓▓▓▓▓▓▓████████████▒                                                                             
███████████▓▓▓▓███████▒                                                                             
▓▓▓▓▓▓▓██████████▓▓▓▓█▒                                                                             
████████▓▓▓▓▓██▓▓▓▓▓▓█▒                                                                             
▓▓▓▓▓▓▓▓▓▓▓▓▓██▓▓▓▓▓▓█▒                                                                             
▓▓▓▓▓▓▓▓▓▓▓▓▓██▓▓▓▓▓▓█▒                                                                             
▓▓▓▓▓▓▓▓▓▓▓▓▓██▓▓▓▓▓▓█▒                                                                             
▓▓▓▓▓▓▓▓▓▓▓███████████▒                                                                             
▓▓▓▓▓▓▓█████▓▓▓▓▓██████                                                                             
▓▓██████▓▓▓▓▓▓████▓▓▓██                                                                             
███▓▓▓▓▓▓▓▓████▓▓▓▓▓▓█▓                                                                             
▓▓▓▓▓▓▓▓███▓▓██▓▓▓▓▓▓█▓                                                                             
▓▓▓▓▓████▓▓▓▓███▓▓▓▓▓██                                                                             
▓█████▓▓▓▓▓████████████                                                                             
██▓▓▓▓▓▓▓███▓▓▓▓▓▓▓██░                                                                              
▓▓▓▓▓▓▓███▓▓▓▓▓▓▓███                                                                                
▓▓▓▓▓███▓▓▓▓▓▓▓▓██                                                                                  
▓▓▓███▓▓▓▓▓▓▓▓██░                                                                                   
▓███▓▓▓▓▓▓▓▓██▓                                                                                     
██▓▓▓▓▓▓▓▓▓██                                                                                       
▓▓▓▓▓▓▓▓▓██░                                                                                        
▓▓▓▓▓▓▓██▓                                                                                          
▓▓▓▓▓███                                                                                            
▒▒▒▒██░                                                                                             
                                                                                                    
                                                                                                    
                                                                                                    
                                                                                                    
