                     ██▓▓▓▓▓▓▓▓▓▓▓▓▓▓▓▓▓▓▓▓▓▓▓▓▓▓▓▓▓▓▓▓▓▓▓▓▓▓▓▓▓▓▓▓▓▓▓▓▓▓▓▓▓▓▓▓██                   
                   ██▓▓▓▓▓▓▓▓▓▓▓▓▓▓▓▓▓▓▓▓▓▓▓▓▓▓▓▓▓▓▓▓▓▓▓▓▓▓▓▓▓▓▓▓▓▓▓▓▓▓▓▓▓▓▓▓▓▓▓▓██                 
                  ██████████████████████████████████████████████████████████████████                
                  ███▓▓▓███████▓▓▓▓▓▓▓▓▓██████████████████████████████████████████▓█                
        ██        ███▓▓▓███████▓▓▓▓▓▓▓██▓▓▓███████▓▓▓▓▓████▓▓██████████▓▓▓▓▓▓▓▓▓▓███                
     ███▓██       ██▓▓▓▓▓▓█████▓▓▓▓▓▓██▓▓▓▓▓▓█████▓▓▓▓▓█▓██▓▓█████▓▓▓██▓▓▓▓▓▓▓▓▓▓███                
  ████▓▓▓█████    █████████████▓▓▓▓▓██▓▓▓▓▓▓▓███████████▓██████████▓▓▓██████████████                
███▓▓▓█████▓▓█    ██████████████████████▓▓▓▓█████████████████████████▓█████████████         ███     
▓▓▓████▓▓▓▓██                            ███                                                ██▓██   
████▓▓▓▓█████                                                                             ███▓▓▓▓███
█▓▓▓▓▓███▓▓██                                                                             █▓███▓▓▓▓█
▓▓▓████▓▓███                                                                           ████▓▓▓████▓▓
▓███▓▓▓███▓██        ████████████████████████████████████████████████                  █▓▓███▓▓▓▓██▓
██▓▓████▓▓▓██       █▓▓▓▓▓▓▓▓██▓▓▓▓▓▓▓▓▓▓▓▓▓▓▓▓▓▓▓▓▓▓▓▓▓▓▓▓▓▓▓▓▓▓▓▓▓▓█                 █▓▓▓▓███▓▓▓██
▓▓███▓▓▓▓██       ██▓▓▓▓▓▓▓▓███████████████████████████████████████████                 ██▓▓▓▓███▓▓▓
███▓▓▓▓██        ██▓▓▓▓▓▓▓▓███▓▓▓▓▓▓▓▓▓▓▓██████▓█▓▓▓▓▓▓▓▓▓▓▓▓▓▓▓████████                  ██▓▓▓▓███▓
▓▓▓▓▓██        ██▓▓▓▓▓▓▓▓██▓██▓▓▓▓▓▓▓▓▓▓▓█████▓▓█▓▓▓▓▓▓▓▓▓▓▓▓▓▓▓████████                 █████▓▓▓▓██
▓▓▓██         █▓▓▓▓▓▓▓▓▓██▓▓▓█▓▓▓▓▓▓▓▓▓▓▓████▓▓▓█▓▓▓▓▓▓▓▓▓▓▓▓▓▓▓█████▓██                 ██▓▓███▓▓▓▓
███         ██▓▓▓▓▓▓▓▓▓██▓▓▓▓█▓▓▓▓▓▓▓▓▓▓▓████▓▓▓█▓▓▓▓▓▓▓▓▓▓▓▓▓▓▓█████▓▓█                 ██▓▓▓▓███▓▓
█          █▓▓▓▓▓▓▓▓▓▓██▓▓▓▓▓█▓▓▓▓▓▓▓▓▓▓▓████▓▓▓█▓▓▓▓▓▓▓▓▓▓▓▓▓▓▓█████▓▓▓█                  ██▓▓▓▓███
          █▓▓▓▓▓▓▓▓▓▓██▓▓▓▓▓█████████████████▓▓███████████████████████▓▓█                    ██▓▓▓▓▓
        ██▓▓▓▓▓▓▓▓▓▓██▓▓▓▓▓█                █▓█                       ███                     ██▓▓▓▓
       █▓▓▓▓▓▓▓▓▓▓██▓▓▓▓▓▓█                 ██         █████████                                ██▓▓
     ██▓▓▓▓▓▓▓▓▓▓██▓▓▓▓▓▓█                  █         ████▓▓▓▓▓▓█████                            ██▓
    █▓▓▓▓▓▓▓▓▓▓▓█████▓▓▓█                            ████▓▓▓▓▓▓▓▓▓▓▓▓████                          █
   █████████████████████                           ███ ██▓▓▓▓▓▓▓▓▓▓▓▓▓▓▓▓████                 ██    
   █▓▓▓▓▓▓▓▓▓▓▓███▓▓▓▓▓█                          ██   ██▓▓▓▓▓▓▓▓▓▓▓▓▓▓▓▓▓▓▓▓████             ████  
   █▓▓▓▓▓▓▓▓▓▓▓███▓▓▓▓▓█                               ██▓▓▓▓▓▓▓▓▓▓▓▓▓▓▓▓▓▓▓▓████             █▓▓██ 
   █▓▓▓▓▓▓▓▓▓▓▓███▓▓▓▓▓█                               ████▓▓▓▓▓▓▓▓▓▓▓▓▓▓▓▓███▓██             █▓▓▓█ 
   █▓▓▓▓▓▓▓▓▓▓▓███▓▓▓▓▓█                              ██   ████▓▓▓▓▓▓▓▓▓▓███▓▓▓██       ███████▓▓██ 
   █▓▓▓▓▓▓▓▓▓▓▓████████                             ██         █████▓▓▓▓▓██▓▓▓▓██      ██▓▓▓▓▓██▓██ 
   █▓▓▓▓▓▓▓▓▓▓▓███                                 ██               ████▓▓▓▓▓▓▓██      ███▓▓▓▓▓████ 
   █▓▓▓▓▓▓▓▓▓▓▓██                                                       █████████      █ ██▓▓▓▓▓███ 
