██▒██▓▓  ▓████▒█░                                                                                   
▓▒▒▒▒█▒██▓▓███                                                                                      
█▒▒▒▓██▓██▓ ░█▓░██▒█▒ ░                                                                             
█▒▒▒▓█▒   ▒░ ▓█▓▓█▓ ███░▒   ░░░█▓▓▓█▓▒▓▒░                                                           
▓▒▒▓█      █▓▓▓▒▒▓█▓█▒▓▒     ░▓▓▓▒▓▓▓▓▓▒                               ░   ░                        
█▒▒█░        ██▒▒▓░            ▓█▒▓                               ▓  ▓██▒▒▓▓███▒░▒█                 
█▒▒▓▒         ▓▒▒░              ▒▒▒                                ██▒ ▒█▓▓▓▓▓░█████▒               
█▒▒▓▓         ▒▒▒░              ▓▒▒                                 ░██▒███▓████▓▓█▓███████  ████▒▒█
▒▒▒▒█        ░▓▒▒▒             ▒▒▒▓                                   ▒██▒███████████████░███▓▒██▒██
▒▒▒▒█        ▒▒▒▒▒            ░▒▒▒▒▓                                    ███▓██▓▓▓▒▒██████████▒▒████▒
▒▒▒▒▓▓      ▒▓▒▒▒▓░                                                     ████████▓█▓▒▒████▓██▒▒▓██▓▒█
▒▒▒▒▒▓░                                                                 █▒▓███████▓▒▓█████▒▒▒▒▓█▒▒██
▓▓▓▓▓▒                                                                 ▓▒▒▒█░██████████ ▒█▓▒▒▒▒▒▒▓█░
                                 █████                                ░▓▒▒▒▓▒ ██▓██▓███  ██▒▒▒▒▒▒███
                                 ▒█▓▒█▓                               █▒▒▒▒▒▓░ █▓▒▓██▓██░▓█▒▒▒▒▒▒███
                  ████            ▓████                                        ▓▓▒▒▓███▓███▒▒▒▒▒▒▓██
                ██▓▒▒▓█                                                        █▓▒▒▓█ ▓█▓██▒▒▒▒▒██  
             ▒██▒▒▒▒██░                                                       ░█▒▒▒▒█  ░██▒▒▒▒▒██   
           ▓██▓▒▒▒██▓                                                         █▓▒▒▒▒█   ░█▓▒▒▒▒██   
          ░██▓▒▒██▒                                                          ░█▒▒▒▒▒▓▓   █▓▒▒▒▒██   
            ░████                                                            █▓▒▒▒▒▒▒█   █▓▒▒▒▒██   
                                                                            █▓▒▒▒▒▒▒▒▓▓ ░█▓▒▒▒▒██   
                                                                            ▒▓████████▓ ██▒▒▒▒▒▓█   
                                                                                        ██▒▒▒▒▒▒█░  
                                                                                       ██▒▒▒▒▒▒▒█▒  
                                                                                      ░█▓▒▒▒▒▒▒▒██  
                                                                                      ██▒▒▒▒▒▒▒▒▓█░ 
                                                                                     ▓█▒▒▒▒▒▒▒▒▒▒██ 
                                                                                    ▒█▓▒▒▒▒▒▒▒▒▒▒▓█▓
                                                                                   ▒█▓▒▒▒▒▒▒▒▒▒▒▒▒▓█
                                                                                   ▒████████████████
                                                                                                    
                                                                                                    
