                                                          ▓░                                 ░▓    ▒
                                                          █░                                 ░▓     
                  ▓███████████▓░                         ███                               ▒███     
              ▓████████████████████░                  ▓██▓▓█▓                            ▒██▓▓██    
           ▒█████████████████████████▓               ▓█▓▓██                             ██▓▓▓█▒     
         ░█████▓▓▓▓▓▓▓▓▓███████████████▒            █████▓                             ███▓██       
        █████▓▓▓▓▓▓▓▓▓▓▓▓▓▓██████████████                                              ██▒█         
       ████▓▓▓▓▓▓▓▓▓▓▓▓▓▓▓▓▓▓█████████████                                                          
      ███▓▓▓▓▓▓▓▓▓▓▓▓▓▓▓▓▓▓▓▓▓█████████████                                                         
     ░██▓▓▓▓▓▓▓▓▓▓▓▓▓▓▓▓▓▓▓▓▓▓▓▓███████████▓                                                        
     ███▓▓▓▓▓▓▓▓▓▓▓▓▓▓▓▓▓▓▓▓▓▓▓▓▓███████████                                                        
     ██▓▓▓▓▓▓▓▓▓▓▓▓▓▓▓▓▓▓▓▓▓▓▓▓▓▓▓██████████▓                                                       
    ░██▓▓▓▓▓▓▓▓▓▓▓▓▓▓▓▓▓▓▓▓▓▓▓▓▓▓▓▓██████████                                                       
    ░██▓▓▓▓▓▓▓▓▓▓▓▓▓▓▓▓▓▓▓▓▓▓▓▓▓▓▓▓█████████▒                                                       
    ░█▓▓▓▓▓▓▓████████▓▓▓▓▓▓▓▓▓▓▓▓▓▓▓████████░                                                       
    ░██▓▓▓▓▓▓██▓▓▓▓▓████████▓▓▓▓▓▓▓▓████████                                                        
     ██▓▓▓▓▓▓████▓▓▓▓▓███▓▓█▓▓▓▓▓▓▓▓███████                                                         
     ██▓▓▓▓▓▓█▓▓██▓▓▓▓▓▓▓▓▓█▓▓▓▓▓▓▓▓▓█████▓                                                         
     ▓█▓▓▓▓▓██▓▓▓▓▓███▓▓▓▓▓█▓▓▓▓▓▓▓▓▓████▓                                                          
     ░█▓▓▓▓▓█████▓▓▓▓▓▓▓██▓█▓▓▓▓▓▓▓▓████░                                                           
      ██▓▓▓▓▓▓▓▓▓▓██████████▓▓▓▓▓▓▓▓██▓                                                             
       ██▓▓▓▓▓▓▓▓▓▓▓▓▓▓▓▓▓▓▓▓▓▓▓▓▓▓▓█▓                                                              
        ██▓▓▓▓▓▓▓▓▓▓▓▓▓▓▓▓▓▓▓▓▓▓▓▓▓██                                                               
         ██▓▓▓▓▓▓▓▓▓▓▓▓▓▓▓▓▓▓▓▓▓▓▓██▒                                                               
          ██▓▓▓▓▓▓▓▓▓▓▓▓▓▓▓▓▓▓▓▓▓██▒                                                                
           ▓██▓▓▓▓▓▓▓▓▓▓▓▓▓▓▓▓▓▓██▒                                                                 
             ▓██▓▓▓▓▓▓▓▓▓▓▓▓▓▓███                                                                   
               ▓███▓▓▓▓▓▓▓▓▓███                                                                     
                  ░████████▓                                                                        
                                                                                                    
                                                                                                    
                                                                                                    
                                                                                                    
