                                                                                                    
                                                                                                    
                                                                                                    
                                                                                                    
                                                                                                    
                            ▓█████████████░                                                         
                            ██▓▓▓▓██▓▓▓▓▓█▒                                                         
                            ██████████████▒                                                         
                            ███████████████                                                         
         ░██████▒░          ██████████▓░░░███                                                       
        ░█▓▒░░░░░░▒▓██░     ███████▓░░░░▒▓███░                    ▒███████▒                         
          ░░▒▓█████▓█▓      ███▓▒░░░░▒████▒                       ▒██▒▒▒▒▒██▒                       
                          ██▒░░░░░▓████▓▓█▒                         ▓█▓░░░░▒██░                     
                          ▒██▒▒▓████▓▓▓▓▓█▒    ░█████████████▒        ██▒░░░░▒██                    
                     ███████████████▓▓▓▓▓█▒   ██▒░░░░░░░░░▒███    ░▒▒▒░▓██▒░░░░▓██                  
                   ▓█▓░░░░░░░░░░██████████▒ ▒█▓░░░░░░░░░░▓█▒░█  ▓█▓▓▓▓▓█▒▓█▓░░░░░▓█▒                
                 ░██░░░░░░░░░░▒██░█       ░███████████████░ ░█   ▓█████▓   ██▒░░░░░██▒              
                ██████▓▓▓▓▒▒▒▓█▓ ░█        █▒           ██       ▓  ▓  █    ░██░░░░░▒██             
                ██   ░░░░░▒▒▒██            █▓           ██       ▓  ▓  █      ▓█▓░░░░░▓██           
                ▓█           ▓█            ██           ▓█       █▓ ▓░▓█░░▓██▓░ ██▒░░░░░▓██         
                             ▒█                                 ░▒  █░ ░█▓▓▓▓▓▓█ ░██░░░░░░██░       
           ████████████                   ░▓█▓▓▓▓▓▓▓▓▓░             ░    ████▓█    ██▓░░░░░▒██░     
          ░█▓░░░░░░░▒██              ░▓██▓▒██                            ▓  █ ▒▒     ██▒░░░░░▒██    
          ██░░░░░░░░███░         ░█████▓▓▓▓██                           ░▒  █ ░▓      ░██░░░░░░▓██  
         ▒█▒░░░░░░░▓█▓█░         ░█▒░░░░░░░██                           ▓█░ █ ▓█        ▓█▓░░░░░░▓█▓
         █▓░░░░░░░░██ ▒          ░█▒░░░░░░░██                           █  ░█  █          ██▒░░░░░▒█
        ██░░░░░░░░██             ░█▒░░░░▒▓███████████▓                     ▒▓      ░▓░     ░██▒░░░░░
       ▒█▒░░░░░░░▒█▓             ░█▒▓███░                                   ░▓   ░▓█▓█░      ▒█▓░░░░
       ██▒▒▒▒▒▒▒▒██               ████████████▓▓▓                          ░█░    █▓▓█▒        ██▒░░
      ▒█▒▒▒▒▒▒▒▒▒█▓                                                         █     ▒█▓█░         ▒██░
      ▓█         █▓                                                        ▒████▓▓▒██▓            ▓█
      ▓█         █▓                                                                                 
                                                                                                    
