                                                                                                    
                                                                                                    
                                                                                                    
                                                                                                    
                                                                                                    
                                                                                                    
                                                                                                    
                                 ░                                                                  
                               ▓██████                         ░▓█▓                                 
                              ██▓▒▒▒▒▓███         ░██████▓░░█████▓██                                
                             ██▓▒▒▒▒▒▒████▓░ ░░▒████▓▓▓▓▓█████▒▒▒▓▓██░                              
                           ░██▓████▓▓███▓▓██████▓▒▒▓▓▓▓▓▓▓▓▓███████▓▓█▒                             
                          ▒██▒▒▓▓▓▓████▓▓▓▓▓▓▓▓▓▓░▒▓▓▓▓▓▓▓▓▓▓██▓▒▒▒▒▒▓██                            
                         ▓█▓▒▒▒▒▒▒▓██▓▓▓▓▓▓▓▓▓▓▓▓▒▒▓▓▓▓▓▓▓▓▓▓███▒▒▒▒▒▒▓██                           
                        ██▓▒▒▒▒▒▒▓██▓▓▓▓▓▓▓▓▓▓▓▓▓▓▓▓▓▓▓▓▓▓▓▓▓▓███▒▒▒▒▒▒▒██░                         
                      ░██▓▒▒▒▒▒▒▓██▓▓▓▓▓▓▓▓▓▓▓▓▓▓▓▓▓▓▓▓▓▓▓▓▓▓▓▓▓██▒▓███▓▒██▒                        
                     ░██▒▒▒▒▒▒▒███▓▓▓▓▓▓▓▓▓▓▓▓▓▓▒░▒▓▓▓▓▓▓▓▓▓▓▓▓▓▓████▓▒▒▒▒▓██                       
                    ▒█▓▒▓███▓▓███▓▓▓▓▓▓▓▓▓▓▓▓▓▓▓▒░▒▓▓▓▓▓▓▓▓▓▓▓▓▓▓███▒▒▒▒▒▒▒▒██                      
                   ██▓▒▒▒▒▓█████▓▓▓▓▓▓▓▓▓▓▓▓▓▓▓▓▒░▒▓▓▓▓▓▓▓▓▓▓▓▓▓▓▓███▒▒▒▒▒▒▒▓██                     
                  ██▓▒▒▒▒▒▒▒███▓▓▓▓▓▓▓▓▓▓▓▓▓▓▓▓▓▒░▒▓▓▓▓▓▓▓▓▓▓▓▓▓▓▓▓███▒▒▒▒▒▒▒▒██▓                   
                 ██▒▒▒▒▒▒▒▓██▓▓▓▓▓▓▓▓▓▓▓▓▓▓▓▓▓▓▓▓▒▓▓▓▓▓▓▓▓▓▓▓▓▓▓▓▓▓▓███▒▒▒▒▒▒▒▒▓██                  
               ▒██▒▒▒▒▒▒▒▓██▓▓▓▓▓▓▓▓▓▓▓▓▓▓▓▓▓▓▓▓▓▓▓▓▓▓▓▓▓▓▓▓▓▓▓▓▓▓▓▓▓██▓▒▓▓███▒▒▓██                 
              ██▓████▒▒▒▓██▓▓▓▓▓▓▓▓▓▓▓▓▓▓▓▓▓▓▓▓▓▓▓▓▓▓▓▓▓▓▓▓▓▓▓▓▓▓▓▓▓▓▓█████▓▓▒▒▒▒▓██░               
             ██▓▒▒▓▓██████▓▓▓▓▓▓▓▓▓▓▓▓▓▓▓▓▓▓▓▓▓▓░░░▓▓▓▓▓▓▓▓▓▓▓▓▓▓▓▓▓▓▓▓██▓▒▒▒▒▒▒▒▒▒▓█▓              
            ██▒▒▒▒▒▒▒▓███▓▓▓▓▓▓▓▓▓▓▓▓▓▓▓▓▓▓▓▓▓▓▓░░░▓▓▓▓▓▓▓▓▓▓▓▓▓▓▓▓▓▓▓▓▓██▓▒▒▒▒▒▒▒▒▒▓█▓             
          ▒██▒▒▒▒▒▒▒▓███▓▓▓▓▓▓▓▓▓▓▓▓▓▓▓▓▓▓▓▓▓▓▓▓░░░▓▓▓▓▓▓▓▓▓▓▓▓▓▓▓▓▓▓▓▓▓▓██▓▒▒▒▒▒▒▒▒▒▓██            
         ▓█▓▒▒▒▒▒▒▒▒███▓▓▓▓▓▓▓▓▓▓▓▓▓▓▓▓▓▓▓▓▓▓▓▓▓░░░▓▓▓▓▓▓▓▓▓▓▓▓▓▓▓▓▓▓▓▓▓▓▓██▓▒▒▒▒▒▒▒▒▒▓██░          
        ██▓▒▒▒▒▒▒▒▓██▓▓▓▓▓▓▓▓▓▓▓▓▓▓▓▓▓▓▓▓▓▓▓▓▓▓▓░░░▓▓▓▓▓▓▓▓▓▓▓▓▓▓▓▓▓▓▓▓▓▓▓▓██▓▒▒▒▒▒▒▒▒▒▒▓█▒         
       ██▓▒▒▒▒▒▒▒▓██▓▓▓▓▓▓▓▓▓▓▓▓▓▓▓▓▓▓▓▓▓▓▓▓▓▓▓▓░░░▓▓▓▓▓▓▓▓▓▓▓▓▓▓▓▓▓▓▓▓▓▓▓▓▓██▓▒▒▒▒▓▓▓▓▓▒▓██        
     ░██▒████▓▒▒▓██▓▓▓▓▓▓▓▓▓▓▓▓▓▓▓▓▓▓▓▓▓▓▓▓▓▓▓▓▓░░░▓▓▓▓▓▓▓▓▓▓▓▓▓▓▓▓▓▓▓▓▓▓▓▓▓▓███████████▒▒▓██       
    ▓█▓▒▒▒▓▓██████▓▓▓▓▓▓▓▓▓▓▓▓▓▓▓▓▓▓▓▓▓▓▓▓▓▓▓▓▓▓░░░▓▓▓▓▓▓▓▓▓▓▓▓▓▓▓▓▓▓▓▓▓▓▓▓▓▓███▓▒▒▒▒▒▒▒▒▒▒▒██░     
   ██▓▒▒▒▒▒▒▒▒███▓▓▓▓▓▓▓▓▓▓▓▓▓▓▓▓▓▓▓▓▓▓▓▓▓▓▓▓▓▓▓░░░▓▓▓▓▓▓▓▓▓▓▓▓▓▓▓▓▓▓▓▓▓▓▓▓▓▓▓███▒▒▒▒▒▒▒▒▒▒▒▒██▒    
  ██▒▒▒▒▒▒▒▒▒███▓▓▓▓▓▓▓▓▓▓▓▓▓▓▓▓▓▓▓▓▓▓▓▓▓▓▓▓▓▓▓▓▓▓▓▓▓▓▓▓▓▓▓▓▓▓▓▓▓▓▓▓▓▓▓▓▓▓▓▓▓▓▓███▓▒▒▒▒▒▒▒▒▒▒▒▓██   
