▓▓▓▓▓▓▓▓▓▓▓▓▓▓▓▓▓▓▓████████▓▓▓▓▓▓▓▓▓▓▓▓▓▓▓▓█████▓▓▓▓▓▓████▓▓▓▓▓▓▓▓▓▓▓▓████                          
▓▓▓▓▓▓▓▓▓▓▓▓▓▓▓█████▓▓▓▓▓▓▓▓▓▓▓▓▓▓▓▓▓▓▓█████▓▓▓▓▓▓█████▓▓▓▓▓▓▓▓▓▓█████                              
▓▓▓▓▓▓▓▓▓▓▓▓████▓▓▓▓▓▓▓▓▓▓▓▓▓▓▓▓▓▓▓▓████▓▓▓▓▓▓▓████▓▓▓▓▓▓▓▓▓▓████                                   
▓▓▓▓▓▓▓▓▓▓███▓▓▓▓▓▓▓▓▓▓▓▓▓▓▓▓▓▓██████▓▓▓▓▓██████▓▓▓▓▓▓▓▓█████                                       
▓▓▓▓▓▓▓████▓▓▓▓▓▓▓▓▓▓▓▓▓▓▓▓▓█████▓▓▓▓▓▓█████▓▓▓▓▓▓▓▓████                                            
▓▓▓▓▓▓▓██▓▓▓▓▓▓▓▓▓▓▓▓▓▓▓▓████▓▓▓▓▓▓▓████▓▓▓▓▓▓▓▓████                                                
▓▓▓▓▓▓▓██▓▓▓▓▓▓▓▓▓▓▓▓▓███▓▓▓▓▓▓▓████▓▓▓▓▓▓▓█████                                                    
▓▓▓▓▓▓▓██▓▓▓▓▓▓▓▓▓▓▓███▓▓▓▓▓█████▓▓▓▓▓█████                                                         
▓▓▓▓▓▓▓██▓▓▓▓▓▓▓▓▓███▓▓▓▓████▓▓▓▓▓████                                                              
▓▓▓▓▓▓▓██▓▓▓▓▓▓▓███▓▓▓▓███▓▓▓▓████                                                                  
▓▓▓▓▓▓▓██▓▓▓▓▓███▓▓▓████▓▓▓███                                                                      
▓▓▓▓▓▓▓██▓▓▓▓▓██▓▓▓██▓▓▓▓██                                                                         
▓▓▓▓▓▓▓██▓▓▓▓▓██▓▓▓██▓███                                   ████                                    
▓▓▓▓▓▓███▓▓▓▓▓██▓▓▓██▓██                     ███████████████▓▓▓████                                 
▓▓▓▓▓▓███▓▓▓▓▓██▓▓███▓██     ███████████████▓▓▓▓▓▓▓▓▓▓▓▓▓▓▓▓▓▓▓▓▓▓▓▓████                            
▓▓▓▓▓▓▓██▓▓▓████▓▓████       ██▓▓▓▓▓▓▓▓▓▓▓▓▓▓▓▓▓▓▓▓▓▓▓▓▓▓▓▓▓▓▓▓▓▓▓▓▓▓▓▓▓█████▓                      
▓▓▓▓▓▓▓██▓▓█████▓▓██           ██▓▓▓▓▓▓▓▓▓▓▓▓▓▓▓▓▓▓▓▓▓▓▓▓▓▓▓▓▓▓▓▓▓▓▓▓▓▓▓▓▓▓▓▓▓████                  
▓▓██▓▓▓██▓▓▓███████              ██▓▓▓▓▓▓▓▓▓▓▓▓▓▓▓▓▓▓▓▓▓▓▓▓▓▓▓▓▓▓▓▓▓▓▓▓▓▓▓▓▓▓▓▓▓▓▓█████             
█████▓▓██▓▓▓███▓▓████              ██▓▓▓▓▓▓▓▓▓▓▓▓▓▓▓▓▓▓▓▓▓▓▓▓▓▓▓▓▓▓▓▓▓▓▓▓▓▓▓▓▓▓▓▓▓▓▓▓▓▓█████        
▓▓▓███▓██▓▓▓▓███████                 ██▓▓▓▓▓▓▓▓▓▓▓▓▓▓▓▓▓▓▓▓▓▓▓▓▓▓▓▓▓▓▓▓▓▓▓▓▓▓▓▓▓▓▓▓▓▓▓▓▓▓▓▓▓█████   
▓▓▓▓█████▓▓▓▓▓██████                  ███▓▓▓▓▓▓▓▓▓▓▓▓▓▓▓▓▓▓▓▓▓▓▓▓▓▓▓▓▓▓▓▓▓▓▓▓▓▓▓▓▓▓▓▓▓▓▓▓▓▓▓▓▓▓▓▓███
▓▓▓▓▓████▓▓▓███   █                     ███▓▓▓▓▓▓▓▓▓▓▓▓▓▓▓▓▓▓▓▓▓▓▓▓▓▓▓▓▓▓▓▓▓▓▓▓▓▓▓▓▓▓▓▓▓▓▓▓▓▓▓▓▓▓▓▓▓
▓▓▓▓▓████████                             ███▓▓▓▓▓▓▓▓▓▓▓▓▓▓▓▓▓▓▓▓▓▓▓▓▓▓▓▓▓▓▓▓▓▓▓▓▓▓▓▓▓▓▓▓▓▓▓▓▓▓▓▓▓▓▓
▓▓▓▓▓████████████                           ██▓▓▓▓▓▓▓▓▓▓▓▓▓▓▓▓▓▓▓▓▓▓▓▓▓▓▓▓▓▓▓▓▓▓▓▓▓▓▓▓▓▓▓▓▓▓▓▓▓▓▓▓▓▓
▓▓▓███▓▓▓▓███▓▓█                              ██▓▓▓▓▓▓▓▓▓▓▓▓▓▓▓▓▓▓▓▓▓▓▓▓▓▓▓▓▓▓▓▓▓▓▓▓▓▓▓▓▓▓▓▓▓▓▓▓▓▓▓▓
▓▓███▓▓▓███▓▓███                                ██▓▓▓▓▓▓▓▓▓▓▓▓▓▓▓▓▓▓▓▓▓▓▓▓▓▓▓▓▓▓▓▓▓▓▓▓▓▓▓▓▓▓▓▓▓▓▓▓▓▓
▓██▓▓▓▓███▓▓▓████                                 ██▓▓▓▓▓▓▓▓▓▓▓▓▓▓▓▓▓▓▓▓▓▓▓▓▓▓▓▓▓▓▓▓▓▓▓▓▓▓▓▓▓▓▓▓▓▓▓▓
██████████████████                                  ██▓▓▓▓▓▓▓▓▓▓▓▓▓▓▓▓▓▓▓▓▓▓▓▓▓▓▓▓▓▓▓▓▓▓▓▓▓▓▓▓▓▓▓▓▓▓
▓▓▓▓▓▓▓▓▓▓▓██  ███                                    ██▓▓▓▓▓▓▓▓▓▓▓▓▓▓▓▓▓▓▓▓▓▓▓▓▓▓▓▓▓▓▓▓▓▓▓▓▓▓▓▓▓▓▓▓
▓▓▓▓▓▓▓▓▓▓▓███                                         ███▓▓▓▓▓▓▓▓▓▓▓▓▓▓▓▓▓▓▓▓▓▓▓▓▓▓▓▓▓▓▓▓▓▓▓▓▓▓▓▓▓▓
▓▓▓▓▓▓▓▓▓██                                              ███▓▓▓▓▓▓▓▓▓▓▓▓▓▓▓▓▓▓▓▓▓▓▓▓▓▓▓▓▓▓▓▓▓▓▓▓▓▓▓▓
████████▓▓██                                               ███▓▓▓▓▓▓▓▓▓▓▓▓▓▓▓▓▓▓▓▓▓▓▓▓▓▓▓▓▓▓▓▓▓▓▓▓▓▓
       ███▓██                                                ███▓▓▓▓▓▓▓▓▓▓▓▓▓▓▓▓▓▓▓▓▓▓▓▓▓▓▓▓▓▓▓▓▓▓▓▓
