                                                                                                    
                                                       █████████████████                            
                                                       ██▒▒▒▒▒▒▒▒▒▒▒▒▓██                            
                                                       ██▒▒█████████▓▓██                            
                                                       ██▒▒█▒▒▒▒▒▒▒█▓▓██                            
                                                       ██▒▒█▒▒▒▒▒▒▒█▓▓██                            
                                                       ██▒▒█████████▓▓██                            
        ████                                           ██▒▒▓▓▓▓▓▓▓▓▓▓▓██                            
       █████                                           ██▒▒▒▒▒▒▒▒▒▒▒▒▓██                            
     ███▒▒▓█                                           ██▒▒▒▒▒▒▒▒▒▓▓▓▓██                            
   ███▓▒▒▒▓██                                          ██▓▓▓▓▓▓▓▓▓▓▓▓▓██                            
 ████▒▒▒▓█▓██                                          ██▓▓█████████▓▓██                            
██▓▒▒▒▓▓▒▒▒▓█                                          ██▒▒█▒▒▒▒▒▒▒█▒▓██                            
▒▒▒▒▓█▓▒▒▒▓█                                           ██▒▒█▒▒▒▓████▒▓██                            
▒▒▓█▓▒▒▒▒▓███                                          ██▒▒█████████▒▓██                            
▓█▓▒▒▒▒▒█▓▓██                                          █████████████████                            
▓▒▒▒▒▒█▓▒▒▒▒██                                                                                      
██▓▓█▓▒▒▒▒▓██                                                                                       
████▒▒▒▒▓███                                                                                        
██▒▒▒▒▒███                                                               ██████████████             
█▒▒▒▒▓██                                                                 ███▓▓▒▒▒▒▒▒▒███            
███▓███                                                                  ███▓▒▒▒▒▒▒▒▒▒███           
██████                                                                   ████▓▒▒▒▒▒▒▒▒▒███          
███                                                                      ██ ██▓▒▒▒▒▒▒▒▒▒███         
                                                                         ██  ██▒▒▒▒▒▒▒▒▒▒███        
                                                                         ██  █▓█▒▒▒▒▒▒▒▒▒▒███       
                                                                              ██▓▒▒▒▒▒▒▒▒▒▒███      
                                                                               ██▓▒▒▒▒▒▒▒▒▒▒███     
                                                                                ██▓▒▒▒▒▒▒▒▒▒▓██     
                                                                                ███████████████     
                                                                                ███████████████     
                                                                                ███         ███     
                                                                                ███         ███     
