                                                                            ▓██▒▒▒▒▒▒▓██           ▒
                                                                          ▒██▒▒▒▒▒▒▓██              
                                                                         ██▒▒▒▒▒▒▓██                
                                                                      ░██▓▒▒▒▒▒███                  
                                                                     ██▓▒▒▒▒▒▓██                    
                                                                   ███▒▒▒▒▒▓██                      
                                                                 ▓██▒▒▒▒▒▓██                        
                                                               ▓██▒▒▒▒▒▓██                          
                                 ▒██▒                        ▒██▒▒▒▒▒▓██                            
                              ░██▒▒██░                      ██▓▒▒▒▒▓██                              
                            ███   █▓██                    ██▓▒▒▒▒▓██                                
                         ██▓░█░  ░█  █▓                 ██▓▒▒▒▒▓██                                  
                      ▓███░  █░  █▓  ░█░              ▓█████████                                    
                   ░███▓ █░  █  ░█    ██████████     ███▓   ██                                      
                  ██  █▓ █░  █  █▓     ██▒▒▒▒█                                                      
                 ░███ █▓ █░ ░█ ░█      ███████                                                      
                 █▒ ████ █░ ░█        ▓█▓▒▒▒▒▒█░                                                    
                ▒█   ███▓█   ▒▓█▒      ████████                                                     
                █▒   ░██▒       ██    █▒▒▒▒▒▒▓▓█                                                    
               ██     ▓█        ██    ░████████                                                     
              ░█░      ██   ░███       ██▓▓▓▓██                                                     
              ▓█                       ██▒▒▒▒██                                                     
                              ████████████████████████▓                                             
                                ███▒▒▒▒▒▒▒▒▒▒▒▒▒▒▒▒███                                              
                                   █████▓▒▒▒▒▒▓████▒                                                
                          ████████████████▓▓████▓██                                                 
                        ██░          ██████████   ██████                                            
                        █▒           ██▒▒▒▒▒▒██        ▒███                                         
                       ████████▒     ▒█████████           ██                                        
                       ██▒▒▒▒▒▒▓█████████████▓▓▓▓▓▓▓▓▓▓▓███▓                                        
                       █████▒▒▒▒▒▒▒▒▒▒▒▒▒▒▒▒▒▒▒▒▒▒▒▒▒▒▒▒▒▓█░                                        
                           ░████████████▓▒▒▒▒▒▒▒▒▒▒▒▒▒▒▒▒██                                         
                                        █████████████████▒                                          
