▒▒▒▒▒▒▒▒▒▒▒▒▒▒▒▒▒▒▒▒▒▒▒▒▒▒▒▒▒▒▒▒▒▒▒▒▒▒▒▒▒▒▒▒▒▒▒▒▒▒▒▒▒▒▒▒▒▒▒▒▒▒▒▒▒▒▒▒▒▒▒▒▒▒▒▒                       ▒
▒▒▒▒▒▒▒▒▒▒▒▒▒▒▒▒▒▒▒▒▒▒▒▒▒▒▒▒▒▒▒▒▒▒▒▒▒▒▒▒▒▒▒▒▒▒▒▒▒▒▒▒▒▒▒▒▒▒▒▒▒▒▒▒▒                        ░░         
▒▒▒▒▒▒▒▒▒▒▒▒▒▒▒▒▒▒▒▒▒▒▒▒▒▒▒▒▒▒▒▒▒▒▒▒▒▒▒▒▒▒▒▒▒▒▒▒▒▒▒▒▒▒▒▒▒▒▒▒▒▒▒▒▒                    ███████        
▒▒▒▒▒▒▒▒▒▒▒▒▒▒▒▒▒▒▒▒▒▒▒▒▒▒▒▒▒▒▒▒▒▒▒▒▒▒▒▒▒▒▒▒▒▒▒▒▒▒▒▒▓▓▓▓▓▓▓▒▒▒▒▒▒                    ███████        
▒▒▒▒▒▒▒▒▒▒▒▒▒▒▒▒▒▒▒▒▒▒▒▒▒▒▒▒▒▒▒▒▒▒▒▒▒▒▒▒▒▒▒▒▒▒▒▒▒▒▒█████████▒▒▒▒▒                    ▓█████▒        
▒▒▒▒▒▒▒▒▒▒▒▒▒▒▒▒▒▒▒▒▒▒▒▒▒▒▒▒▒▒▒▒▒▒▒▒▒▒▒▒▒▒▒▒▒▒▒▒▒▒▒█████████▒▒▒▒▒                    ▓█████▒        
▒▒▒▒▒▒▒▒▒▒▒▒▒▒▒▒▒▒▒▒████████▒▒▒▒▒▒▒▒▒▒▒▒▒▒▒▒▒▒▒▒▒▒▒████████▓▒▒▒▒▒                     ░░░░          
▒▒▒▒▒▒▒▒▒▒▒▒▒▒▒▒▒▒▒▒████████▒▒▒▒▒▒▒▒▒▒▒▒▒▒▒▒▒▒▒▒▒▒▒████████▓▒▒▒▒▒                                   
▒▒▒▒▒▒▒▒▒▒▒▒▒▒▒▒▒▒▒▒████████▒▒▒▒▒▒▒▒▒▒▒▒▒▒▒▒▒▒▒▒▒▒▒████████▓▒▒▒▒▒            ░░                ░▓█▓ 
▒▒▒▒▒▒▒▒▒▒▒▒▒▒▒▒▒▒▒▒████████▒▒▒▒▒▒▒▒▒▒▒▒▒▒▒▒▒▒▒▒▒▒▒▒▒▒▒▒▒▒▒▒▒▒▒▒▒       ▓██████               ▓███▓ 
▒▒▒▒▒▒▒▒▒▒▒▒▒▒▒▒▒▒▒▒████████▒▒▒▒▒▒▒▒▒▒▒▒▒▒▒▒▒▒▒▒▒▒▒▒▒▒▒▒▒▒▒▒▒▒▒▒▒       ███████               ▓████▓
▒▒▒▒▒▒▒▒▒▒▒▒▒▒▒▒▒▒▒▒▒▒▒▒▒▒▒▒▒▒▒▒▒▒▒▒▒▓▓████████▓▒▒▒▒▒▒▒▒▒▒▒▒▒▒▒▒▒       ███████           ▒▓████▓▒░ 
▒▒▒▒▒▒▒▒▒▒▒▒▒▒▒▒▒▒▒▒▒▒▒▒▒▒▒▒▒▒▒▒▒▒▒▒▒██████████▓▒▒▒▒▒▒▒▒▒▒▒▒▒▒▒▒▒       ███████   ░▓████▓░          
▒▒▒▒▒▒▒▒▒▒▒▒▓▓▓▓▓██▓▒▒▒▒▒▒▒▒▒▒▒▒▒▒▒▒▒██████████▓▒▒▒▒▒▒▒▒▒▒▒▒▒▒▒▒▒       █████████▒                  
▒▒▒▒▒▒▒▒███████████▓▒▒▒▒▒▒▒▒▒▒▒▒▒▒▒▒▒██████████▓▒▒▒▒▒▒▒▒▒▒▒▒▒▒▒▓▓░░▒█████▒░                         
▒▒▒▒▒▒▒▒████████████▒▒▒▒▒▒▒▒▒▒▒▒▒▒▒▒▒██████████▓▒▒▒▒▒▒▒▒▒▓███████▒░                                 
▒▒▒▒▒▒▒▒████████████▒▒▒▒▒▒▒▒▒▒▒▒▒▒▒▒▒▓█████████▓▒▓███████▒                                          
▒▒▒▒▒▒▒▒████████████▒▒▒▒▒▒▒▒▒▒▒▒▒▒▒▒▒▓███████████▓░                                                 
▒▒▒▒▒▒▒▒████████████▓▒▒▒▒▒▒▒▒▒▒▒▓▓███████▓▒                                                         
▒▒▒▒▒▒▒▒█████████████▒▒▒▒▓███████▒                                                                  
▒▒▒▒▒▒▒▒█████████████████▓░                                                                         
▒▒▒▒▒▒▒▒██████████▒                                                                                 
▒▓███████▓░                                                                                         
█▓░                                                                                                 
                                                                                                    
                                                                                                    
                                                                                                    
                                                                                                    
                                                                                                    
                                                                                                    
                                                                                                    
                                                                                                    
                                                                                                    
