                                            ░▓█████▓▒░░███                     ▒██▒                 
                                    ░▓█████▓██  ░██    ███                     ██▒▓███▓             
                                    █░  █░  ██  ░██    ███                     ██░░░░░▓███▓         
                                    █░  █░  ██  ░██    ███                     ██░░░░░░░░░█████▒░   
                                    █░  █░  ██  ░██    ███                     ██░░░░░░░░░██░░▒▓████
                  ░█                █░  █░  ██  ░██    ███                     ██░░░░░░░░░██░░░░░░░░
            ▒████▓░██               █░  █░  ██  ░██    ███                     ██░░░░░░░░░██░░░░░░░░
     ░▓██████▓     ██               █░  █░  ██  ░██    ███                     ██░░░░░░░░░██░░░░░░░░
████▓░ ██  ████    ██               █░  █░  ██  ░██    ███                     ██░░░░░░░░░██░░░░░░░░
 ░█    ██  ██ ░█▓  ██               █░  █░  ██  ░██   ▒███                     ██░░░░░░░░░██░░░░░░░░
 ░█    ██  ██  ▒█  ██               █░  █░  ██  ▒█████▒                        ██▒░░░░░░░░██░░░░░░░░
 ░█    ██  ██  ▒█  ▒█               █░  █░  ████▓░                              ░▓███▒░░░░██░░░░░░░░
 ░█    ██  ██  ▒█  ▒█               █░ ▓███▓                                         ▓███▒██░░░░░░░░
 ░█    ██  ██  ▒█  ▒█               ███░                                                 ████▒░░░░░░
 ░█    ██  ██  ▒█  ▒█                                                                        ▓███▓▒░
 ░█    ██  ██  ▒█  ▒█                                                                            ▒██
 ░█    ██  ██  ▒█████                                                                               
 ░█    ██  ██████                                                                                   
 ░█   ▒███▓▒█▓ ▒█                                                                                   
 ████▒       ▓███                                                                                   
▓             ░██                                                                       ██          
                                                                                        ██          
                                                                                 ▓████████          
                                                                                 █▓░▒▒▒▒█▒          
                                                                                 █▓░░░░░█▒          
                                                                                 ████████▒          
                                                                                                    
                                                                                                    
                                                                                                    
                                                                                                    
                                                                                                    
                                                                                                    
                                                                                                    
