                                                                                                   ░
                                                                                                    
                                                                                                    
                                                                                                    
                                                                                                    
                                                                                                    
                                                                                                    
                            ░▓███▓▒░                                                                
                     ░▓████████▓████████████▓▒░                                                     
               ░███████▓▓▓▓▓▓▓███████▓▓▓▓▓▓▓▓██████████▓░                                           
              ▓██▓▓▓▓▓▓██████████████████████████▓▓▓▓▓████████████▓░░                               
              ██████████████▓▓▓▓██▓▓▓▓▓▓▓▓█████████████████▓▓▓▓▓▓█████████████▓▒░                   
              ██▓█████▓▓▓▓▓▓▓▓▓▓██▓█████▓▓▓▓▓▓▓▓▓▓▓▓████████████████▓▓▓▓▓▓▓▓█████████░              
              ██▓███▓▓▓███████████▓▓▓██████████████▓▓▓▓▓▓▓▓▓▓▓▓▓▓████████████████▓▓▓█▒              
              ██▓██████████▓▓▓▓▓██▓▓▓▓▓▓▓▓▓▓▓███████████████▓▓▓▓▓▓▓▓▓▓▓▓▓▓████████▓▓█▒              
              ▓█▓███▓▓▓▓▓▓▓▓▓▓▓▓██▓▓▓▓▓▓▓▓▓▓▓▓▓▓▓▓▓▓▓▓███████████████▓▓▓▓▓▓▓▓▓▓██▓▓▓█▒              
              ▒█▓███▓▓▓▓▓▓▓▓███▓██▓▓████████▓▓▓▓▓▓▓▓▓▓▓▓▓▓▓▓▓▓▓▓▓▓██████████▓▓▓██▓▓▓█▒              
              ▒█▓███▓▓████████▓▓██▓▓▓▓▓▓▓█████████████▓▓▓▓▓▓▓▓▓▓▓▓▓▓▓▓▓▓▓▓██▓▓▓██▓███████▓░         
              ▒█▓███▓▓█▓▓▓▓▓▓██████████▓▓▓▓▓▓▓▓▓▓█████████████▓▓▓▓▓▓▓▓▓▓▓▓▓▓▓▓▓█████▓▓▓▓▓████████▒░ 
              ▒█▓███▓▓▓▓▓█████░      ▒███████▓▓▓▓▓▓▓▓▓▓▓█████████████▓▓▓▓▓▓▓▓▓▓██████████▓▓▓▓▓▓▓████
              ░███████████                 ░▓████████▓▓▓▓▓▓▓▓▓▓▓▓▓█████████▓▓▓▓██▓▓▓▓▓██████████▓▓▓▓
                █████▓                            ░▓█████████▓▓▓▓▓▓▓▓▓▓▓▓▓▓▓▓▓▓██▓▓▓▓▓▓▓▓▓▓▓▓███████
                                                         ░▒▓███████▓▓▓▓▓▓▓▓▓▓▓▓██▓▓▓▓▓▓▓▓▓▓▓▓▓▓▓▓▓▓█
                                                                 ░███████▓▓▓▓▓▓██▓▓▓▓▓▓▓▓▓▓▓▓▓▓▓▓▓▓▓
                                                                        ▒█████████▓▓▓▓▓▓▓▓▓▓▓▓▓▓▓▓▓▓
                                                                               ▒███████▓▓▓▓▓▓▓▓▓▓▓▓▓
                                                                                    ░▓███████▓▓▓▓▓▓▓
                                                                                           ▒██████▓▓
                                                                                                 ▒██
                                                                                                    
                                                                                                    
                                                                                                    
░                                                                                                   
