                                                                                                    
                                                                                                    
                                                                                                    
                                                                                                    
                                                                                                    
                                                                                                    
                                                                                                    
                                                                                                    
                                                                                                    
                                                                   ████████                         
                                                         ████████  █      █ █████████               
                                                         ██▓▓▓▓▓██ █      █ ██▓▓▓▓▓██               
                                                         ██▓▓▓▓▓██ █      █  ██▓▓▓▓██               
                                                         ██▓▓▓▓▓██ █      █  ██▓▓▓▓██               
                                                         ██████▓██ █      █  ████████               
                             ░▓▒                            ██████ █      █   ██████                
                               ▓▓▓░                                █      █                         
                                 ▒▓▓▒                              █      █                         
                                    ▓▓▓░                           █      █                         
                                      ▓▓▓▒                         █      █                         
                                       ▓▓▓▓▓                       █      █                         
                                         ▓▓▓▓▓░                    █      █                         
                                           ▓▓▓▓▓▒                  ████████                         
                                             ▓▓▓▓▓▓░                                                
                                               ▓▓▓▓▓▓▓░                              █              
                                                 ▓▓▓▓▓▓▓███▓▓▓▓▓▓▓▓▓▓▓▓▓▓▓▓▓▓▓▓▓▓▓▓▓██              
                                                   ▓▓▓▓▓███▓███▓▓███▓▓▓██▓▓▓██▓▓███▓██              
                                                     ▓▓▓███▓███▓▓███▓▓▓██▓▓▓██▓▓███▓██              
                                                      ▓▓███████▓▓███▓▓▓██▓▓▓██▓▓███▓██              
                                                         ▓▓█████████▓▓▓██▓▓▓█████████               
                                                                   █████████                        
                                                                                                    
                                                                                                    
