                  ▒█░░░░░░░░░░░░░░░░░░░░░░░░░▒█▓      ██░░░░░░░░░░▒▒░░░░░░░░░░▓█         ▒█▒░░░░░░░▓
                  ▒█░░░░░░░░▒██▒░░░░▓▓░░░░░░░▒█▓      ██░░░░░▒█▓██▓██▓▒░░░░░░░▓█         ▒█▒░▒▓█▒░░░
                  ▒█░░░░░░░░██▓░░░░░██▒░░░░░░▒█▓      ██░░▒█▓░░██░▒▒░▒██░░░░░░▓█         ▒█▒▓█▒░███▒
                  ▒█▒███▓▒░▒██░░░░░░░▓█▒░░░░░▒█▓      ██░░██▒░░░░▒██▒░▒██▓▒░░░▓█         ▒█▒▒▒░░░░░░
                  ▒██▒░▒▓███▓█▓░░░░░░▓█▒░░░░░▒█▓      ██░░▒▓█▓░░▒▓███▒░░▒██▒░░▓█         ▒█▒░░░░░░░░
                  ▒█░░░░░░░░░▒███░░░░░░░░░░░░▒█▓      ██░░░░▒█▒░▒██░░░░░▒██▒░░▓█         ▒█▒░░░░░░░░
                  ▒█░░░░░░░░░░░▒█▒░░░░░░░░░░░▒█▓      ██░░░░░░░░░▓█▒░░░░░▒▒░░░▓█         ▒█▒░░░░░░░░
                  ▓████████████████████████████▒      ██████████████████████████         ░██████████
                                                                                                    
                                                                                                    
                                                                                                    
                                                                                                    
                                                                  ░█████████████████████████████████
                                                                 ██▓▓▓▓▓▓▓▓██▓▓▓▓▓▓▓▓███▓▓▓▓▓██▓▓▓▓▓
                                                               ███▓▓▓▓▓▓▓▓██▓▓▓▓▓▓▓▓██▓▓▓▓▓▓▓██▓▓▓▓▓
                                                            ░███▓▓▓▓▓▓▓▓▓██▓▓▓▓▓▓▓▓██▓▓▓▓▓▓▓▓██▓▓▓▓▓
                                                       ██████████████████████████▓██▓▓▓▓▓▓▓▓▓██▓▓▓▓▓
                                                       ██▓▓▓▓▓▓▓▓▓▓▓▓▓▓▓▓▓▓▓▓███████████████████████
                                                      ▒█▓▓▓▓▓▓▓▓▓▓▓▓▓▓▓▓▓▓▓▓▓▓▓▓▓▓▓▓▓▓▓▓▓▓▓▓▓▓▓▓▓▓▓▓
                                                      ██▓▓▓▓▓▓▓▓▓▓▓▓▓▓▓▓▓▓▓▓▓▓▓▓▓▓▓▓▓▓▓▓▓▓▓▓▓▓▓▓▓▓▓▓
                                                      ██▓▓▓▓▓▓▓▓▓▓▓▓▓▓▓▓▓▓▓▓▓▓▓▓▓▓▓▓▓▓▓▓▓▓▓▓▓▓▓▓▓▓▓▓
                                                      ██▓▓▓▓▓▓▓▓▓▓▓▓▓▓▓▓▓▓▓▓▓▓▓▓▓▓▓▓▓▓▓▓▓▓▓▓▓▓▓▓▓▓▓▓
                                                      ▒██████████████████████████████████▓▓▓▓▓▓▓▓▓▓▓
                                                                                      ░░▓███████████
                                                                                                    
                                                                                                    
                                                                                                    
                                                                                                    
                                                                                                    
                                                                                                    
                                                                                                    
                                                                                                    
                                                                                                    
