                                                                                                    
                                                                                                    
                                                                                                    
                                                                                                    
                                                                                                    
                                                                                                    
                                                                                                    
                                                                                                    
                                                                                                    
                                                                                                    
                                                                                                    
                                                                                                    
                                                                     ░▒█████████████████            
                                                                ██████▓▒▒▒▒▓██▒▒▒▒▒▒▒▒██            
                                                               ▒█▓▒▒▒▒▒▒▒▒▒▓██▒▒▒▒▒▒▒▒██            
                                                               ▒█▓▒▒▒▒▒▒▒▒▒▓█████▒▒▒▒▒██            
                                                               ▒█▓▓███████▓▓██▓████▒▒▒██            
                                                               ▒█▓██▓▒▒▒▒█████▒▒█████▒██            
                                                               ▒█▓██▒▒▒▒▓██▓██▒▒▓██▓▒▒██            
                                                               ▒█▓██▒▒▒▒▓██▓██▒▒▒██▓▒▒██            
                                                               ▒███▓▒▒▒▒▓██▓██▒▒▒██▓▒▒██            
                                                               ▒███▓▒▒▒▒▓██▓██▒▒▒▓█▓▒▒██            
                                                               ▒███▓▒▒▒▒▓█▓▓██▒▒▒▓██▒▒██            
                                                               ▒█████████▓▒▓██▒▒▒▓██▒▒██            
                                                               ▒█▓▒▒▒▒▒▒▒▒▒▓██▓████▓▒▒██            
                                                               ▒█▓▒▒▒▒▒▒▒▒▒▓██▓█▓▒▒▒▒▓██            
                                                               ▒█▓▒▒▒▒▒▒▒▒▒▓██▒▒▒▒▒▒▒▓█▓            
                                                               ▒██▒▒▒▒▒▒▒▒▒▓██▒▒▒▒▒▒▒▓█▓            
                                                                 ███▓▓▒▒▒▒▒▓██▒▒▒▒▒▒▒▓█▓            
                                                                    ▓███▒▒▒▓██▒▒▒▒▒▒▒▓█▓            
                                                                       ▓███▓██▒▒▒▒▒▒▒▓█▓            
                                                                          ▓████████████▓            
                                                                                                    
