                                                ██                                                  
                                               ████                                                 
                                             ▓██▓████░                                              
                                           ▓██▓▓▓██▓▓████▓▒░                                        
                                         ███▓▓▓▓▓██▓▓▓▓▓▓▓████████▒                                 
                                █▓    ███▓▓▓▓▓▓▓▓██▓▓▓▓▓▓▓█▓▓▓▓▓▓█▒                                 
                               ███▓███▓▓▓▓▓▓▓▓▓▓▓▓██▓▓▓▓▓████▓▓▓▓█▒                                 
                             ▓███████▓▓▓▓▓▓▓▓▓▓▓▓▓██▓▓▓▓▓██████▓▓█▒                                 
                           ▓██▓▓▓██▓█████▓▓▓▓▓▓▓▓▓██▓▓▓▓████████▓█▒                                 
                         ▓██▓▓▓▓▓██▓▓▓▓▓████████████▓▓▓███████████▒                                 
                      ░███▓▓▓▓▓▓▓██▓▓▓▓▓▓▓▓▓▓▓▓▓████▓▓██████████░                                   
            ▒▒     ▓███▓▓▓▓▓▓▓▓▓▓██▓▓▓▓▓▓███▓▓▓▓████▓███████▓                                       
            ███  ███▓▓▓▓▓▓▓▓▓▓▓▓▓▓██▓▓▓▓▓█████▓▓█████████░                   ██          ████       
            ████ ██▓▓▓▓▓▓▓▓▓▓▓▓▓▓▓██▓▓▓▓███████▓██████                     ██▓██░       ░█▓▓█▓      
          ██▓▓▓████▓▓▓▓▓▓▓▓▓▓▓▓▓▓▓██▓▓▓███████████░                       ░██▓▓▓███▓░  ███▓██       
         ▒█▓▓▓▓▓███▓▓▓▓▓▓▓▓▓▓▓▓▓▓▓██▓▓██████████▒                       ▒██▓▓▓▓▓▓▓▓▓████▓▓██░       
         ██▓▓▓▓▓▓▓███▓▓▓▓▓▓▓▓▓▓▓▓▓██▓████████░                          ▒█▓▓▓▓▓▓▓▓███▓▓▓▓██         
       ░██▓▓▓▓▓▓▓▓▓▓███▓▓▓▓▓▓▓▓▓▓▓████████                              ██▓▓▓▓▓▓██████▓▓▓████       
       ██▓▓▓▓▓▓▓▓▓▓▓▓█████████████████▒                                 ██▓▓▓▓████████▓▓▓▓▓▓██░     
       ██▓▓▓▓▓▓▓▓██████▓▓█████▒▒▒▒▒                                      ▓████████████▓▓▓▓▓██░      
      ▒█▓▓▓▓▓▓▓▓▓▓█████████████                                                 ███████▓▓███        
    ▓██▓▓▓▓▓▓▓▓▓▓▓███████████                                                        ░███▒          
     ▓███▓▓▓▓▓▓▓▓▓█████████▓                                                                        
         ███████▓▓▓███████                                                                          
               ▓██▓████                                                                             
                 ░▒▒░                                                                               
                                                                                                    
                                                                                                    
                                                                                                    
                                                                                                    
                                                                                                    
                                                                                                    
                                                                                                    
