                                                                                                    
                                                                                                    
██                                                                                                  
▒▓███░                                                                                              
▒▒▒▒▓███░                                                                                           
▒▒▒▒▒▒▒▒███                                                                                         
▒▒▒▒▒▒▒▒▒▒▓███░                                                                                     
▒▒▒▒▒▒▒▒▒▒▒▒▒▓███░                                                                                  
▒▒▒▒▒▒▒▒▒▒▒▒▒▒▒▒▒███░                                                                               
▒▒▒▒▒▒▒▒▒▒▒▒▒▒▒▒▒▒▒▒███░                                                                            
█▓▒▒▒▒▒▒▒▒▒▒▒▒▒▒▒▒▒▒▒▒▓███░                                                                         
░███▓▒▒▒▒▒▒▒▒▒▒▒▒▒▒▒▒▒▒▒▒▓███▒                                                                      
   ░███▒▒▒▒▒▒▒▒▒▒▒▒▒▒▒▒▒▒▒▒▒▒███▒                                                                   
      ▓██▓▒▒▒▒▒▒▒▒▒▒▒▒▒▒▒▒▒▒▒▒▒▒███░                                                                
         ▓██▓▒▒▒▒▒▒▒▒▒▒▒▒▒▒▒▒▒▒▒▒▒▓███▒                                                             
            ███▓▒▒▒▒▒▒▒▒▒▒▒▒▒▒▒▒▒▒▒▒▒▒███▒                                                          
               ███▒▒▒▒▒▒▒▒▒▒▒▒▒▒▒▒▒▒▒▒▒▒▒███▒                                                       
                 ▒███▒▒▒▒▒▒▒▒▒▒▒▒▒▒▒▒▒▒▒▒▒▒▒███▒                                                    
                    ▓██▓▒▒▒▒▒▒▒▒▒▒▒▒▒▒▒▒▒▒▒▒▒▒▒███▒                                                 
                       ▓██▓▒▒▒▒▒▒▒▒▒▒▒▒▒▒▒▒▒▒▒▒▒▒▒███▓                                              
                          ███▒▒▒▒▒▒▒▒▒▒▒▒▒▒▒▒▒▒▒▒▒▒▒▒███▒                                           
                            ▒███▒▒▒▒▒▒▒▒▒▒▒▒▒▒▒▒▒▒▒▒▒▒▒▒███▒                                        
                               ▒███▒▒▒▒▒▒▒▒▒▒▒▒▒▒▒▒▒▒▒▒▒▒▒▒███▓                                     
                                  ▓██▓▒▒▒▒▒▒▒▒▒▒▒▒▒▒▒▒▒▒▒▒▒▒▒▒███▓                                  
                                     ███▒▒▒▒▒▒▒▒▒▒▒▒▒▒▒▒▒▒▒▒▒▒▒▒▒███▒                               
                                       ░███▒▒▒▒▒▒▒▒▒▒▒▒▒▒▒▒▒▒▒▒▒▒▒▒▒███▒                            
                                          ░███▒▒▒▒▒▒▒▒▒▒▒▒▒▒▒▒▒▒▒▒▒▒▒▒▒▓██▓                         
                                             ▒██▓▒▒▒▒▒▒▒▒▒▒▒▒▒▒▒▒▒▒▒▒▒▒▒▒▒▓██▓                      
                                                ███▓▒▒▒▒▒▒▒▒▒▒▒▒▒▒▒▒▒▒▒▒▒▒▒▒▒███▓                   
                                                  ░███▓▒▒▒▒▒▒▒▒▒▒▒▒▒▒▒▒▒▒▒▒▒▒▒▒▒███▓                
                                                     ░███▒▒▒▒▒▒▒▒▒▒▒▒▒▒▒▒▒▒▒▒▒▒▒▒▒▒▓██▓             
                                                        ▒██▓▒▒▒▒▒▒▒▒▒▒▒▒▒▒▒▒▒▒▒▒▒▒▒▒▒▒▓██▓          
                                                           ▓██▓▒▒▒▒▒▒▒▒▒▒▒▒▒▒▒▒▒▒▒▒▒▒▒▒▒▒▓██▓       
