                                                                 ░██▓▒▒▒▒██▓▒▒██                    
                                                                 ██▒▒▒▒▒▒▒██▓▒▒██      ░▓█          
                                                                 ██▒▒▒▒▒▒▒▒██████░  ████▓▓█░        
                                                                 ██▒▒▒▒▒▒▒▒▒██▒▓████▓▓██▒▒██░       
                                                                 ██▒▒▒▒▒▒▒▒▒██▓██▓▒▒▒▒▓██▒▒██░      
                                        ██████████████▓▓░        ██▒▒▒▒▒▒▒▒▒████▒▒▒▒▒▒▒▓██▒▒██      
                                       ▒█▓▒▒▒▒▒▒▒▒▒▒▒▒▓██░       ██▒▒▒▒▒▒▒▒▒████▒▒▒▒▒▒▒▒▓█████▒     
                                        ████████▓▓▓▒▒▒▒██░░▓▓    ░███▓▒▒▒▒▒▓█▓██▒▒▒▒▒▒▒▒▒██▒▒█▒     
                                                ▒▒▓████████████      ███▓▒▒▓█▓██▒▒▒▒▒▒▒▒▒██▒▒█▒     
          ▒████▓                                    █████████████▒  ▓████████▓██▒▒▒▒▒▒▒▒▒██▒▒█▒     
       ░████▒▒▓█▓                               ░█████████████████████▒▒▓█▓█████▒▒▒▒▒▒▒▒▒██▒▒█▒     
    ░███▓▒▓██▒▒▓█▓                           ░████████████████████▒▒▓██▒▒██░   ▓███▒▒▒▒▒▒██▒▒█▒     
   ██▓▒▒▒▒▒▒██▒▒▓█░                       ░████████████████████▒▒▒▒▒▒▓██▒▒██      ▓███▒▒▒██▒▒█▒     
   ██▒▒▒▒▒▒▒▒██▒███                       ░████████████████████▒▒▒▒▒▒▒███▓███        ▓█████▓██░     
   ██▒▒▒▒▒▒▒▒▓█████                          ▓█████████████▓ ██▒▒▒▒▒▒▒▒▓██▓██           ▒▓█▓░       
   ██▒▒▒▒▒▒▒▒▓█▓▒▓█         ▓████░             ░█████████▒   ██▒▒▒▒▒▒▒▒▓█▓▒██                       
   ██▒▒▒▒▒▒▒▒▓█▓▒▓█      ▒███▓▒▒██                █████░     ██▒▒▒▒▒▒▒▒▓█▓▒██                       
   ██▒▒▒▒▒▒▒▒▓█▓▒▓█   ░███▒▒██▓▒▒██                 ░        ██▒▒▒▒▒▒▒▒▓█▓▒██                       
   ██▓▒▒▒▒▒▒▒▓█▓▒▓█  ██▓▒▒▒▒▒██▓▒▒██                         ██▓▒▒▒▒▒▒▒██▓▒██                       
     ▓███▒▒▒▒▓█▒▒▓█  █▓▒▒▒▒▒▒▒██▓▓███                          ███▓▒▒▒▒██▓▒██                       
        ▓██▓▒▓█▒▒▓█  █▓▒▒▒▒▒▒▒▒███▓██            ▒▓               ███▓▒██▓▒██                       
           ▓██████▒  █▓▒▒▒▒▒▒▒▒██▓▒██        ▓███▓██░                ▓██████▒                       
                     █▓▒▒▒▒▒▒▒▒██▓▒██     ▓██▓▓██▒▒██░                                              
                     █▓▒▒▒▒▒▒▒▒██▓▒██   ██▓▒▒▒▒▓██▒▒██░                                             
                     ██▒▒▒▒▒▒▒▒██▒▒██  ██▒▒▒▒▒▒▒▓██▒▒██                                             
                      ▒███▓▒▒▒▒██▒▒██  ██▒▒▒▒▒▒▒▒▓█████░                                            
                         ░███▓▒██▒▒██  ██▒▒▒▒▒▒▒▒▒██▒▓█░                                            
                             ███████░  ██▒▒▒▒▒▒▒▒▒██▒▓█░                                            
                                       ██▒▒▒▒▒▒▒▒▒██▒▓█░                                            
                                       ██▒▒▒▒▒▒▒▒▓██▒▓█░                                            
                                        ███▓▒▒▒▒▒▓█▓▒▓█░                                            
                                           ███▓▒▒▓█▓▒▓█░                                            
                                              ▓█████▓██░                                            
