░░░░░░░░░░░░░░░░░░░░░░░░▒▓█████▒                                                                    
░░░░░░░░░░░░░░░░░░░░░░░░░░░░▒▒▒▓████░                                                               
░░░░░░░░░░░░░░░░░░░░░░░░░░░░░░░░░░░▒▓████░                                                          
░░░░░░░░░░░░░░░░░░░░░░░░░░░░░░░░░░░░░░░░▒██                                                         
░░░░░░░░░░░░▒▓▓▒░░░░░░░░░░░░░░░░░░░░░░░░░▓█                                                         
░░░░░░░░░░▓██████░░░░░░░░░░░░░░░░░░░░░░░░▓█                                                         
░░░░░░░░░▒███████▒░░░░░░░░░░░░░░░░░░░░░░░▓█                                                         
░░░░░░░░░▒████████▓▒░░░░░░░░░░░░░░░░░░░░░▓█                                                         
░░░░░░░░░▒██████████░░░░░░░░░░░░░░░░░░░░░▓█                                                         
░░░░░░░░░░██████████▓░░░░░░░░░░░░░░░░░░░░▓█                                                         
░░░░░░░░░░▒█████████░░░░░░░░░░░░░░░░░░░░░▓█                                                         
░░░░░░░░▒▓████████▒▒░░░░░░░░░░░░░░░░░░░░░▓█                                                         
░░░░░░░░▒███████▓░░░░░░░░░░░░░░▓███▒░░░░░▓█                                                         
░░░░░░░░▒███████▓░░░░░░░░░░░░▒▓███▓░░░░░░▓█                                                         
░░░░░░░▒████████▓░░░░░░░░░░░░▓████▒░░░░░░▓█                                                         
░░░░░░▒█████████░░░░░░░░░░░░▓██████▒░░░░░▓█                                                         
░░░░░▒████████▒░░░░░░░░░░░▒████████▒░░░░░▓█                                                         
░░░░▒████████░░░░░░░░░░░░░▓█████░░░░░░░░░▓█                                                         
░░░░▒███████░░░░░░░░░░░░░░░▒████░░░░░░░▒▓██                                                         
░░░░▒▓█████▒░░░░░░░░░░░░░░░░▒██▒░░░░░▒███                                                           
░░░░░░░░░░░░░░░░░░░░░░░░░░░░░░░░░░░▒▓█▓                                                             
░░░░░░░░░░░░░░░░░░░░░░░░░░░░░░░░░▒███                                                               
░░░░░░░░░░░░░░░░░░░░░░░░░░░░░░░░██▓                                                                 
░░░░░░░░░░░░░░░░░░░░░░░░░░░░░▒███                                                                   
░░░░░░░░░░░░░░░░░░░░░░░░░░░▒▓██                                                                     
░░░░░░░░░░░░░░░░░░░░░░░░░▒███                                                                       
░░░░░░░░░░░░░░░░░░░░░░░░███                                                                         
░░░░░░░░░░░░░░░░░░░░░▒███                                                                           
░░░░░░░░░░░░░░░░░░░▒▓██                                                                             
░░░░░░░░░░░░░░░░░▒▓██                                                                               
░░░░░░░░░░░░░░░░▓█▓                                                                                 
░░░░░░░░░░░░▒▒███                                                                                   
▓░░░░░░░░░░▒▓██                                                                                     
