                                                                                                    
                                                                                                    
                                                                                                    
                                                                                                    
                                                                                                    
                                                                                                    
                                                                                                    
                                                                                                    
                                                                                  ░█████▓           
                                              ░███░                       ▒▒░▒▓██▓██▓▓▓▓█▓          
                                         ░▒████▓▓▓███                   ░▒▓░░░░▒█▓██  ▒█▓▓▓▓▓█░     
                                     ▒█████▓▓▓▓▓▓▓▓▓███                   ▓     █▓██  ▒ █▓▓▓▒▓      
                                ░█████▓▓▓▓▓▓▓▓▓▓███████░             ░░░░████▓   ▓▓█  ▒ █▓░▒█▓▓▓▓▓█ 
                             ▓███▓▓▓▓▓▓▓▓▓▓██████▓▓▓▓██░                    ░████░▓░ ░▓▒▓▒░░░█████▒ 
                             ██████▓▓▓██████▓▓▓▓▓▓▓▓▓██░                    ░█████████░▓▓▓████░▓░ ▒ 
                             ██▓▓▓██████▓▓▓▓▓▓▓▓▓▓▓▓▓██▓                    ░█▓▓▓▓▓▓▓█ ░  ░░░▒ ▓░ ▒ 
                             ██▓▓▓▓▓██▓▓▓▓▓▓▓▓▓▓▓████░                      ░█▓▓▓▓▓▓▓█      ▓███▓██ 
                             ██▓▓▓▓▓██▓▓▓▓▓▓█████░                   ▒▒░░     ▓███▓▓▓█      ▓  ▓░ ░ 
                             ▒████▓▓██▓▓████▓░                           ░░░▒▒▒▒▓▓████              
                                 ▒██████░                                                           
                                                                                                    
                                                                                                    
                                                                                ▓█▓                 
                                                                             ████▓███               
                                                                          ▒███▓▓▓▓▓▓▓██░            
                                                                          █████▓▓▓▓▓▓▓▓██▓          
                                                                          ██▓▓███▓▓▓▓▓▓▓▓███        
                                                                          ██▓▓▓▓███▓▓▓▓▓▓▓▓▓██░     
                                                                          ███▓▓▓▓▓███▓▓▓▓▓▓▓▓▓██▓   
                                                                           ░███▓▓▓▓▓████▓▓▓▓▓▓████  
                                                                              ███▓▓▓▓▓▓███▓████▓██  
                                                                                ▓██▓▓▓▓▓▓███▓▓▓▓██  
                                                                                  ▓██▓▓▓▓██▓▓▓▓▓▓█░ 
