                                                             ██░░██    █░░██                        
                                                           ██░░░░██   █░░░░█                        
                                                          ██░░░░░██    █████                        
                                                         ███████████████████████████████████████████
                                                         ██░░░░░░██        █                        
                                                         ██░░░░░░██        █                        
                                                         ██░░░░░░██        █                        
                                                         ██░░░░░░██        █                        
                                                         ██░░░░░░██        █                        
                           █████████████                 ██░░░░░░██        █                        
                         ██░░███░░░███░░█                ██░░░░░░██        █                        
                          █████░░░░░█████    ██████████████░░░░░░██                                 
                            ██████████     ███░░░░░░░░░░░██░░░░░░██                                 
             ███               ██░░█      ██░░░░░░░░░░░░░███░░░░░██                                 
           ███████             █░░░██     ██████████████████░░░░░██                                 
          █████░░██            █░░░░█     █░░░░░░██████████░░░░░░░█                                 
         ██░██░░░░█           ██░░░░█     █░░░░░███████████░░░░░░░█                                 
          █░░██░░░█            ██████     █░░░░░███████████░░░░░░██                                 
          █░░██░░████                     █████████████████░░░░░██                                  
          █░░░█████████████                               █░░░░██                                   
          ██░░██░███░░░██░██                              ██████                                    
          ██████████████████                                ███                                     
          █░░░░░░█████████                                                                          
          ██░░░░░░░█░░░░██                                                                          
          ██░░░░░░░█░░░░░██                                                                         
           ████████████████                                                                         
                                                                                                    
                                                                                                    
                                                                                                    
                                                                                                    
                                                                                                    
                                                                                                    
                                                                                                    
