        ▓███▒░░░░░░░░▒██░░░░░░░░░░░░░░░░░░░░▒██▒████░                                               
           ░███▒░░░░░▒██░░░░░░░░░░░░░░░░░░░░▒██▒░░▒▒████░                                           
               ███▓▒░▒██░░░░░░░░░░░░░░░░░░░░▒██▒░░░░░░░▒████░                                       
                  ▒█████░░░░░░░░░░░░░░░░░░░░▒██▒░░░░░░░░░░░▒████▒                                   
                      ▓███▒░░░░░░░░░░░░░░▒█▒▒██▒░░░░░░░░░░░░░░▒▒▓███▓                               
                          ███▓░░░░░░░░░░░▓█▓▒████▓░░░░░░░░░░░░░░░░░▓█████                           
                             ▓███▒▒░░░░░░░░░▒████▓░░░░░░░░░░░░░░░░░▓█▓░░▓███▓                       
                                ░███▓▒░░░░░░▒██▒░░░░░░░░░░░░░░░░░░░▓█▓░░░░░▒▓████░                  
                                    ▒███▒░░░▒██▒░░░░░░░░░░░░░░░░░░░▓█▓░░░░░░░░░▒▒▓███▒              
                                        ███▓▒██▒░░░░░░░░░░░░░░░░░░░▓█▓░░░░░░░░░░░░░░▒▓███▒          
                                           ▓███▒▒░░░░░░░░░░░░░░░░░░▓█▓░░░░░░░░░░░░░░░░██▒▓███▒      
                                              ░▓███▒░░░░░░░░░░░░░░░▓█▓░░░░░░░░░░░░░░░░██░░░░▒▓███▓░ 
                                                  ▒███▒░░░░░░░░░░░░▓█▓░░░░░░░░░░░░░░░░██░░░░░░░░▒▒██
                                                      ███▓▒░░░░░░░░▓█▓░░░░░░░░░░░░░░░░██░░░░░░░░░░░░
                                                         ▒███▓▒░░░░▓█▓░░░░░░░░░░░░░░▒▒██░░░░░░░░░░░░
                                                             ▓███▒░▓█▓░░░░░░░░░░░░░█████░░░░░░░░░░░░
                                                                ░████▓░░░░░░░░░░░░░░░░██▓██▓░░░░░░░░
                                                                    ▓██▓▒▒░░░░░░░░░░░░██░▒▒░░░░░░░░░
                                                                       ▒███▓▒░░░░░░░░░██░░░░░░░░░░░░
                                                                           ▒███▒░░░░░░██░░░░░░░░░░░░
                                                                              ░███▓▒░░██░░░░░░░░░░░░
                                                                                  ▓█████░░░░░░░░░░░░
                                                                                     ░████▒░░░░░░░░░
                                                                                         ▒███▒░░░░░░
                                                                                             ███▓▒░░
                                                                                                ▒███
                                                                                                    
                                                                                                    
                                                                                                    
                                                                                                    
                                                                                                    
                                                                                                    
                                                                                                    
