                                                                                                   ▒
                                                                                                    
                                                                                                    
                                                                                                    
                                                                                                    
                                        ░▒▒▒▓▓████▓▓▒░                                              
                         ░▓█▓▓▓▓█████▓▓▓▓▓▓▓▒▒▒▒▒▒▒▒▓▓▓█░                                           
                         ░▓▓▒▒▒▒▒▒▒▒▒▒▒▒▒▒▒▒▒▒▒▒▒▒▒▒▒▒▓█░                          ░▓▓▓▓░░░░        
                        ░▓█▒▒▒▒▒▒▒▒▒▒▒▒▒▒▒▒▒▒▒▒▒▒▒▒▒▒▒██                        ░▒██▓▒▒▓███▒░       
            ░▒█▒▓███▓░  ░█▓▒▒▒▒▒▒▒▒▒▒▒▒▒▒▒▒▒▒▒▒▒▒▒▒▒▒▒▓█░                       ▒███▒▒▒▒▒▒▒██░░░    
         ░░▓█▓▒▒▒▒▒▒██░ ░▓█▓▓▓▓▓▓▓▓▓▓▓▓▓▓▓▓▓▓▓▓▓▓▓▓▓▓▓▓█░                       ▒█▒▓█▓▒▒▒▒▒▒▓██▒░░  
      ░▒██▓▓▒▒▒▒▒▒▒▒█▓░   ░░░░░░░░░░░░░░░▒▒▒▒▒▒░░░▒▒▒▒▒░                        ▓█▒▒▒██▒▒▒▒▒▒▒▒▓██░ 
    ░▒█▓▒▒▒▒▒▒▒▒▒▒▒▓█▒                                                          ██▒▒▒▒▓██▓▓▒▒▒▒▒▒▓█▒
  ░▒██▒▒▒▒▒▒▒▒▒▒▒▒▒▓█░                                                         ░█▓▒▒▒▒▒▒▒▓██▓▒▒▒▒▒▒▓
 ░██▒▒▒▒▒▒▒▒▒▒▒▒▒▒▒██░                                                         ░█▓▒▒▒▒▒▒▒▒▒▓██▒▒▒▒▒▒
 ▒█▒▒▒▒▒▒▒▒▒▒▒▒▒▒▒▓█░                                                          ▒█▓▒▒▒▒▒▒▒▒▒▒▒██▓▒▒▒▒
░▒█▒▒▒▒▒▒▒▒▒▒▒▒▒▓█▓░                                                           ░██▒▒▒▒▒▒▒▒▒▒▒▒▒███▓▒
▓█▓▒▒▒▒▒▒▒▒▒▒▓██▓░                                                              ░██▒▒▒▒▒▒▒▒▒▒▒▒▒▒▒▓█
█▓▒▒▒▒▒▒▒▒▒▒▓█▒░                                                                 ░▓█▒▒▒▒▒▒▒▒▒▒▒▒▒▒▒▓
█▒▒▒▒▒▒▒▒▒▒██░░                                                                   ░▓█▓▒▒▒▒▒▒▒▒▒▒▒▒▒▒
█▓▒▒▒▒▒▒▒▓█▓                                                                        ▒█▓▒▒▒▒▒▒▒▒▒▒▒▒▒
░▓▓██████▓░                                                                          ░█▓▒▒▒▒▒▒▒▒▒▒▒▒
                                                                                      ░██▒▒▒▒▒▒▒▒▒▒▒
                                                                                       ░▓█▓▒▒▒▒▒▒▒▒▒
                                                                                        ░▒█▓▒▒▒▒▒▒▒▒
                                                                                          ▒█▓▒▒▒▒▒▒▒
                                                                                           ░██▒▒▒▒▒▒
                                                                                            ░▓█▒▒▒▒▒
                                                                                             ░▓█▓▒▒▒
                                                                                               ▒█▓▒▒
                                                                                                ░█▓▒
                                                                                                 ░██
░                                                                                                 ░█
