                                                                                                    
                                                                                                    
                                                                                                    
                                                                                                    
                                                                                                    
                                                                                                    
                                                                                                    
                                                                                                    
                                                                                                    
                                                                                                    
                                                                 ░▒▓██████████████████▓░            
                                                                ░███▒▒▒▒▒▒▒▒▒▒▒▒▒▒▒▓████            
                                                                  ░▓▓▓▓██▓▓▓▓▓▓▓▓▓▓██               
                                                                       ██          ▒█               
                                                ▒▓▓▒                   ▓█          ▒█               
                                              ▓██▒▒██                  ██          ██               
                                            ░██▒▒▒▒▒█▒                ███▒        ████              
                                           ██▓▒▒▒▒▒▒█▒                                              
                                          ██▒▒▒▒▒▒▒██▒                                              
                                         ██▒▒▒▒▒▒▒▒██▒                                              
                                       ▒█▓▒▒▒▒▒▒▒▒█▓█▒                                              
                                      ▓█▒▒▒▒▒▒▒▒▓█▒ █▓                                              
                                     ▓█▒▒▒▒▒▒▒▒▒█▒  ▓█                                              
                                     █▓▒▒▒▒▒▒▒▒██   ▒█                                              
                                     █▓▒▒▒▒▒▒▒██    ███                                             
                                     █▓▒▒▒▒▒▒▓█      ▒                                              
                                   ▓███▒▒▒▒▒▒█▒                                                     
                                 ░█▒  ▓██████▓                                                      
                               ░██         █▒                                                       
                           ▒▓▒█▓         ░█░                                                        
                           ███          ░█░                                                         
                           ██▓         ██░                                                          
                                      ▓██▓                                                          
